 6 912
Mp1441
ATGGTCGTTACAGCGATGACAAACGATGGTGAAGGGAAGGAAAAGGCCATAGACCTTACAGAAAAAGAGGAATCAGAATC
CGATTCTTCCTCCTCAAGTAGCGATTCAGATATAGACTCGGACGAAAGCGAAATAATTACAGAAGAGTATTTGGAATCTC
TCTTGGAGAAGGCAAGACAGAACCTAGCTTCAGCCTCGAAGGATTCCACTCACGGTGGACATGAAGAGCAAGTCTTAGTA
TTGGAAAAGGATTCCACAGCGTACGTCCCAGACGCTCGGAGAACGAACGTGCCATTAACTCTAGAATGTAGCCCCCTACC
AGAACTGGATCCCGGCACAGTGCCGACTCCATACTTTACGCTTGGAAAAAGTCGCAACGAAGGACCGTCCTCACTCCGAG
ATCCTGATGTAGAACGCGTAGAGAGTTCGGCATCGTCACTCGATATGCCTGCACCTCCCGTACCACCTCCCGAACTGTCA
AAGTCGGGAAAGTCGTTCACTAAGAGGCAGAAGAAGGAGCTAAGAAATAAAACAGCGGGACCGGATTGGTTCGATATGCC
CGCACCAGCAGAGGCAGACTTGCCTCGGTTATATCGTGAAGTGGAGGCACTGCGCCTTCGTAATCAACTGGACCCTAAAC
GGTTCTACAGAAAGGAAGAGGGGGAAGGAAAGGGCNNNATCNNAAAGGACTAGCACTTTGCTATTGGAACCATCGTCTCG
ACCAACACACCATTCGGCAGTGGTTCTGGGCAGAACCTCACCAGAGCTGATCGCAAAAGGACATTGGTGGATGAATTGGT
GGATGATGCAGAGACTAAACATTACGCAAAGAAGAAGTTCAATGACTTGCAGTCTGTCAGGGGTGCAAGGGGAAAAAACA
CGCGACATGCAAAGACAAAGCATTTAAAGTTC

Mp178
ATGGTCGTTACAGCGATGACAAACGATGGTGAAGGGAAGGAAAAGGCCATAGACCTTACAGAAAAAGAGGAATCAGAATC
CGATTCTTCCTCCTCAAGTAGCGATTCAGATATAGACTCGGACGAAAGCGAAATAATTACAGAAGAGTATTTGGAATCTC
TCTTGGAGAAGGCAAGACAGAACCTAGCTTCAGCCTCGAAGGATTCCACTCACGGTGGACATGAAGAGCAAGTCTTAGTA
TTGGAAAAGGATTCCACAGCGTACGTCCCAGACGCTCGGAGAACGAACGTGCCATTAACTCTAGAATGTAGCCCCCTACC
AGAACTGGATCCCGGCACAGTGCCGACTCCATACTTTACGCTTGGAAAAAGTCGCAACGAAGGACCGTCCTCACTCCGAG
ATCCTGATGTAGAACGCGTAGAGAGTTCGGCATCGTCACTCGATATGCCTGCACCTCCCGTACCACCTCCCGAACTGTCA
AAGTCGGGAAAGTCGTTCACTAAGAGGCAGAAGAAGGAGCTAAGAAATAAAACAGCGGGACCGGATTGGTTCGATATGCC
CGCACCAGCAGAGGCAGACTTGCCTCGGTTATATCGTGAAGTGGAGGCACTGCGCCTTCGTAATCAACTGGACCCTAAAC
GGTTCTACAGAAAGGAAGAGGGGGAAGGAAAGGGCNNNATCNNAAAGGACTAGCACTTTGCTATTGGAACCATCGTCTCG
ACCAACACACCATTCGGCAGTGGTTCTGGGCAGAACCTCACCAGAGCTGATCGCAAAAGGACATTGGTGGATGAATTGGT
GGATGATGCAGAGACTAAACATTACGCAAAGAAGAAGTTCAATGACTTGCAGTCTGTCAGGGGTGCAAGGGGAAAAAACA
CGCGACATGCAAAGACAAAGCATTTAAAGTTC

Mp4071
ATGGTCGTTACAGCGATGACAAACGATGGTGAAGGGAAGGAAAAGGCCATAGACCTTACAGAAAAAGAGGAATCAGAATA
CGATTCTTCCTCCTCAAGTAGCGATTCAGATATAGACTCGGACGAAAGCGAAATAATTACAGAAGAGTGTTTGGAATCTC
TCTTGGAGAAGGCAAGACGGAACCTAGCTTCAGCCTCGAAGGATTCCACTCACGGTGGACATGAAGAGGAAGTCTTAGTA
TTGGAAAAGGATTCCACAGCGTACGTCCCAGACGCTTGGAGAATAAATGTGCCATTAACTCTAGAATGTAGCCCCTTACC
GGAACTGGATNCCGGCAAAGTGCCGACNNCNNNNNNNNNNNNNNNNNNNNNNNNNNNNNNNNNNNNNTCCTCACTCCGAG
ATCCTGATGTAGAACGCGTAGAGAGTTCGGCATCGTCACTCGATATGCCTGCACCTCCCGTACCACCTCCAGAACTGTCA
AAGTCGGGAAAGTCGTTCACCAAGAGGCAGAAGAAGGAGCTAAGAAATAAAACGGCGGGACCGGATTGGTTCGATATGCC
CGCACCAGCAGAGGCAGACTTGCCTCGGTTATATCGTGAAGTGGAGGCACTGCGCCTTCGTAATCAACTGGACCCTAAAC
NNNNNNNNNNNNNNNNNNNNNNNNNNNNNNNNNNNNNNNNNNNNNNNNNNNNNNNNNNNNNNNNNNNNNNNNNNNNNNNN
NNNNNNNNNCCATTCGGCAGTAGTTCTGGCCAGAACCTCACCAGAGCTGATCGCAAAAGGACATTGGTGGATGAATTGGT
GGATGATGCAGAGACTAAACGTTACGCAAAGAAGNNNTTCAATGACTTGCAGTCTGTCAGGGGTGCAAGGGGAAAAAACA
CGCGACATGCAAAGACAAAGCATTTAAAGTTC

Mp4124
ATGGTCGTTACAGCGATGACAAACGATGGTGAAGGGAAGGAAAAGGCCATAGACCTTACAGAAAAAGAGGAATCAGAATA
CGATTCTTCCTCCTCAAGTAGCGATTCAGATATAGACTCGGACGAAAGCGAAATAATTACAGAAGAGTATTTGGAATCTC
TCTTGGAGAAGGCAAGACGGAACCTAGCTTCAGCCTCGAAGGATTCCACTCACGGTGGACATGAAGAGGAAGTCTTAGTA
TTGGAAAAGGATTCCACAGCGTACGTCCCAGACGCTTGGAGAATAAATGTGCCATTAACTCTAGAATGTAGCCCCTTACC
GGAACTGGATCCCGGCAAAGTGCCGACTCCATACTTTACGCTTGGAAAAAGTCGCAACGAAGGACCGTCCTCACTCCGAG
ATCCTGATGTAGAACGCGTAGAGAGTTCGGCATCGTCACTCGATATGCCTGCACCTCCCGTACCACCTCCAGAACTGTCA
AAGTCGGGAAAGTCGTTCACCAAGAGGCAGAAGAAGGAGCTAAGAAATAAAACGGCGGGACCGGATTGGTTCGATATGCC
CGCACCAGCAGAGGCAGACTTGCCTCGGTTATATCGTGAAGTGGAGGCACTGCGCCTTCGTAATCAACTGGACCCTAAAC
GGTTCTACAGAAAGGAAGAGGGAGAAGGAAAGGGCNNNATCNNAAAGGACTAGCACTTTGCTATTGGAACCATCGTCTCG
ACCAACACACCATTCGGCAGTAGTTCTGGCCAGAACCTCACCAGAGCTGATCGCAAAAGGACATTGGTGGATGAATTGGT
GGATGATGCAGAGACTAAACGTTACGCAAAGAAGNNNTTCAATGACTTGCAGTCTGTCAGGGGTGCAAGGGGAAAAAACA
CGCGACATGCAAAGACAAAGCATTTAAAGTTC

Mp4145
ATGGTCGTTACAGCGATGACAAACGATGGTGAAGGGAAGGAAAAGGCCATAGACCTTACAGAAAAAGAGGAATCAGAATC
CGATTCTTCCTCCTCAAGTAGCGATTCAGATATAGACTCGGACGAAAGCGAAATAATTACAGAAGAGTATTTGGAATCTC
TCTTGGAGAAGGCAAGACAGAACCTAGCTTCAGCCTCGAAGGATTCCACTCACGGTGGACATGAAGAGCAAGTCTTAGTA
TTGGAAAAGGATTCCACAGCGTACGTCCCAGACGCTCGGAGAACGAACGTGCCATTAACTCTAGAATGTAGCCCCCTACC
AGAACTGGATCCCGGCACAGTGCCGACTCCATACTTTACGCTTGGAAAAAGTCGCAACGAAGGACCGTCCTCACTCCGAG
ATCCTGATGTAGAACGCGTAGAGAGTTCGGCATCGTCACTCGATATGCCTGCACCTCCCGTACCACCTCCCGAACTGTCA
AAGTCGGGAAAGTCGTTCACTAAGAGGCAGAAGAAGGAGCTAAGAAATAAAACAGCGGGACCGGATTGGTTCGATATGCC
CGCACCAGCAGAGGCAGACTTGCCTCGGTTATATCGTGAAGTGGAGGCACTGCGCCTTCGTAATCAACTGGACCCTAAAC
GGTTCTACAGAAAGGAAGAGGGGGAAGGAAAGGGCNNNATCNNAAAGGACTAGCACTTTGCTATTGGAACCATCGTCTCG
ACCAACACACCATTCGGCAGTGGTTCTGGGCAGAACCTCACCAGAGCTGATCGCAAAAGGACATTGGTGGATGAATTGGT
GGATGATGCAGAGACTAAACATTACGCAAAGAAGAAGTTCAATGACTTGCAGTCTGTCAGGGGTGCAAGGGGAAAAAACA
CGCGACATGCAAAGACAAAGCATTTAAAGTTC

MrPeru
ATGGTCGTTACAGCGATGACAAACGATGGTGAAGGGAAGGAAAAGGCCATAGACCTTACAGAAAAAGAGGAATCAGAATC
CGATTCTTCCTCCTCAAGTAGCGATTCAGATATAGACTCGGACGAAAGCGAAATAATTACAGAAGAGTATTTGGAATCTC
TCTTGGAGAAGGCAAGACAGAACCTAGCTTCAGCCTCGAAGGATTCCACTCACGGTGGACATGAAGAGCAAGTCTTAGTA
TTGGAAAAGGATTCCACAGCGTACGTCCCAGACGCTCGGAGAACGAACGTGCCATTAACTCTAGAATGTAGCCCCCTACC
AGAACTGGATCCCGGCACAGTGCCGACTCCATACTTTACGCTTGGAAAAAGTCGCAACGAAGGACCGTCCTCACTCCGAG
ATCCTGATGTAGAACGCGTAGAGAGTTCGGCATCGTCACTCGATATGCCTGCACCTCCCGTACCACCTCCCGAACTGTCA
AAGTCGGGAAAGTCGTTCACTAAGAGGCAGAAGAAGGAGCTAAGAAATAAAACAGCGGGACCGGATTGGTTCGATATGCC
CGCACCAGCAGAGGCAGACTTGCCTCGGTTATATCGTGAAGTGGAGGCACTGCGCCTTCGTAATCAACTGGACCCTAAAC
GGTTCTACAGAAAGGAAGAGGGGGAAGGAAAGGGCNNNATCNNAAAGGACTAGCACTTTGCTATTGGAACCATCGTCTCG
ACCAACACACCATTCGGCAGTGGTTCTGGGCAGAACCTCACCAGAGCTGATCGCAAAAGGACATTGGTGGATGAATTGGT
GGATGATGCAGAGACTAAACATTACGCAAAGAAGAAGTTCAATGACTTGCAGTCTGTCAGGGGTGCAAGGGGAAAAAACA
CGCGACATGCAAAGACAAAGCATTTAAAGTTC
