 6 4059
Mp1441
ATGTCGAATCACGTTCTATCTCATGCTCTACATGGCCTGCCTGTGATAAAGAAACTTAAAGGAAGAAAAATAGTCCTTGC
TTCGAACAGTCCTCGTCGGAAAGCCATCTTGGAAACACTCGGCCTTGCACCCGACATCGTTCCGTCAAAATTTGAGGAAG
ATCTTGGGACAGACTCGTTCCCCGACCTGCACGAGTACCCAGTGGCCACAGCTTCTCACAAAGCAGTGGAGGTTTACGAG
AGGCTTGTGACAGAAAACCCCGACGATGCGCCCGATCTAGTCATTGCTGCAGACACTATCGTGTTAACACACGCACAGCC
CTCAACATCTCAGACGGGTTATAGTGTGCTCCCTGAAATCACTCAAGAGCTATTGGAGAAACCAAAGGATAAGGAAGATA
ACCTNNNNNACGGATGGGATATGAATGGGAGTGTATGTGAGGTCGTTACAGGAGTCACTGTCGTTTATCCTGTCCTTCAG
TCTCCTGGTTACGCCATTCGCCGACGCCGGTGTANNNNNNNNNNNNNCTTTGCAGATAATCCAACTCATTTGTTGAAGGC
ATATGCGGACTGTGGAGAGGGTGTCGATCGCGCAGGCGGATTCGCGATTCAGGGACTGGGCTCACTGCTGATTCGTAAAA
TCGAGGGAGATTATAACAACGTGGTTGGATTTCCGGCAGCTTCATTCTTCAAGCTTCTTGATTTGATTTTGGAAGAGGAT
GAAGACTTTTTGAGCATGATAATCCCGGTATCTGCTGCAGATGGCAATACGACTGACAAAGAACGCCAGCGAGCGGCAAT
TTCTGCAGCGGCTAGAAATATGGATCGTGATGTCATAGTTGCTAAATATGACCTTCCATTGACCACCACCTTCCTCACCT
TGACCATTGACTCAGCACTGAAGCTTGAAGCTTACCATCACGATGAGCATGCCAACAGGAGATTCTTCATAGGTCCCATG
CCTGAAAGGGCTGTACCAGGCATAGACGCACTTGCTGCTTCAAAGAAGAAAGGAAAGCACCGCCTACTATACTACTCTGG
CGAAAATGAGGATGAGGCAGCTGTAGACCGCATCGTTCAAGAGAGTGCCTTCAGCTATTTCCTCAGTCGAGGTGGTCGGN
NNNNNGAAGAGNNNNNNNGACTGGNNNNGGCGTCGNNAGAGGAGATGAAACGTATATGGCGGGAAAGCCCATGGGGAGTC
TACCTGCAAAGCCGTCGGAACGACTCGACAAAGCGACCTGCAAATCGCTGGGTCGGAAGCAGTTTCGAGGTTGGAGAAAT
TGCTGGTTTCAATGTCATTCAAGAGGCAGACGCAATCACCTCCATGATTTCAAGCCGTACTTCGGCCTTCTCAGGCTCAA
ACACCAACTTTGCCGCTTCTACTCAGTACCTTCCCCTGGACGGCGCAGTAGAGCAGCTTAATTCACCTCCCAGGCCGACT
GTCACCACGACAAAGTCTTCTGGCCAGGATACCTTTTTCACGGCACGGTCAAGACTATCGTCGAGGACATCTAGCTCCAG
CAATGCTAGACCTAGTACGCCTCCAAAGGCGTCCATCAGCACACCAGTACCGGATGGCTCGCCTATCTCTGGTAACGGTA
CCCTTGCACTCAATGACTCACACAGTTCCTCAACAACGGCATTGCTGCCTTCTCCAACAATGCCCAGAATTGACTCAGCC
ATCAGTCAAACGCGTTCAGAGGCACCTCGTCGGCCTATCATAAAGCTGCCCTCTTTTGCCAAGAGTGACAGCGCACCTGT
CACGCAGAAGCCGGACAACAAAGGAAAGGGGAAAAAGGCGGTTCATTATGATCTGTCACCTATCACGCCATCTCCTACCG
GTGAACCAGCACCTCCCAGTGAGGTTTTGGAACGAGAGGGTGAAGAAGTGGAGGATACGAGTGCTGGTGCCATGAATACC
CCTACGACACCTACAGGAGATGCTGAAGTCAAGTGGGGAGCGATCGAGCTGAGAGTCATTCAAGACAGGATGCTTGTACG
CATAATCTCGTCTGACTTGACTGCTGTCCCGTCTTCCTTTGACGAGCAGAAACATCGCCAAACAAGGGATCTCAAGCATG
AGGGCTGGGGCGAGTTCATGGTTGTTTGGCGCGGTGACCGCGTTGAAGTATACGAAAACTATNNNNNNNNNNNNNNNNNN
NNNNNNNNNNNNNACAAGAACTTATCCTATGTCATTCCCTGGAAGTCAGGGCGAACCAAACTGTCCATATACTCGTTCGT
CGACCTAACATTCTGCATAACATGTCCCCCGGTATCGAGACGTTACAATCCAGCTTCGAGGAAGTGGAAACTCACCGTTG
CGAAGCAAAAGACGATGGTGTATATCTTTAAGCTCAAGAGTCGTTCAAGGGCGTTTGATTGGGCATGGCAACTATGGCGT
CGGATCCAACCCTTAAATTCAAAACTACCGCCTTATGTGACTATTAAGAATCCCCGCCTCGACAGCAAAGTCAACATTGA
ATTACCGACTGATCCTGAACGACAGTATGCGGTATTCACCAGAGAGAACGTCGTCAATCTGTGCATCGAGAGCCTGAGTC
ATTTGCGGGACTTCCAGTACCTGGTTGAGCGACATAGGGCCGAAGGAAGGGTTTTCCAACTCGCTTGGAGGAGAGAGACG
CACTTGGATTGGATTTGGCTGGACGAAGACGTTGATGGTAGGCCCCGCGATTGGGCTGTTTTGTGTGGTTTGTTGATGCA
AGAATCCAGCGTTCCTGCACATCTGGAACTCCGACTCTGCCGACATTTCCCTAGCTTCATCCCCCTCAAAGATGGCAGCC
ATTTTTCAGAACCGTTGCCTATCGAAGGATACGTCGATCGAATCAAACCCGGCTCGGGAGCGAAGCAGCCTTTGTATCTC
GCCGTACATGACNGNNNNNNNNNNNNNNNNNNNNNNNNNNATNCNAACCCGCCAGTCCNGCNAGGCNCNCTTCCTCGGAA
AGCGGGCACAATGGNATCATACATCGAGAACATGAAAAGATCTGNGGTTCAGAGGGGCGTCANGCAAATCANGNTTGCTA
NTGGTGNTGCTGATTTAAGGAATGTTCTTGCCGTTAGACGAGCTATTCATCTTGTCATGCAATGTGACCATGATTACAAG
GATCGTCCAGAAGACGAGAACTGGATGAATGCTTGGTCTGAGGAAGAAACATTCCCAGCGGATTTCGAAGATACAGGCGG
AGAAGAGGCGTTGAATCAGACTTCGGATAAACACGACTTGAAGATGAGGCGTTCATTTGAACTCTTATTCAAAAATGGGC
ATGTCGTGAGATTCGAGGCTTATTCTTGCGCGTTTGCCATTGATTGGGTTCGTCGACTTCGGGAATTGGTGCACTACTGG
AGGCTTAAGCGTCGCTATGACGCTAAAGATGAAATGGATCTTGCTCAAGCACTGCGACCCCGTGTAACACCCAAGAGATA
TGCGGAACAGGACNNNNNNNNNNNNNNNNNNNNNNNNNNNNNNNNNNNNNNNNNNNNNNNNNNNNNNNNNNNNNNNNNNN
NNNNNNNNNNNNNNNNNNGCTGTAGGCCGATACTCAGAGGGGGCAAGTTGTTTTCAAGACGTGGATTCAATGGGCAATAC
CGACTGGTGCAGATGTTCCTTTTGCCAGAGTATCTTGTTCAATTTCACATCAAACCCCAATCACAACTTCATCTGTCAGA
GCCCAGGAAAATCCATCTCATAGACGCCTATGCTTGCTCCGGTTACTTCGCTGCTCAGAGACTACCACGAGGACAATATG
ACGCGAATGCTGAATGTGTTGCTCATCGTTATGAAGACGGGTTGGAGGCCGATGACCCTGACGAGGACAAACTCTTCATC
GTGTGGTACAAATCTCCCCCGAAGAACAAAGATCCACTCTCGGAAAATGGAACCACGCCACCGTTGGATGCGAAACGGAA
GGTGGCAGTTTTCCGGACGAGGAGTAAACTGGAAAGAGATGCCTGGTGTTGGGCGTTGAACTGTGCCATCGAGAAAATAG
TTCGTGAGCGCAAGGATAGGGAGACGAAGATGAGGGAAACTGGCGGATTGATGCAAATA

Mp178
ATGTCGAATCACGTTCTATCTCATGCTCTACATGGCCTGCCTGTGATAAAGAAACTTAAAGGAAGAAAAATAGTCCTTGC
TTCGAACAGTCCTCGTCGGAAAGCCATCTTGGAAACACTCGGCCTTGCACCCGACATCGTTCCGTCAAAATTTGAGGAAG
ATCTTGGGACAGACTCGTTCCCCGACCTGCACGAGTACCCAGTGGCCACAGCTTCTCACAAAGCAGTGGAGGTTTACGAG
AGGCTTGTGACAGAAAACCCCGACGATGCGCCCGATCTAGTCATTGCTGCAGACACTATCGTGTTAACACACGCACAGCC
CTCAACATCTCAGACGGGTTATAGTGTGCTCCCTGAAATCACTCAAGAGCTATTGGAGAAACCAAAGGATAAGGAAGATA
ACCTNNNNNACGGATGGGATATGAATGGGAGTGTATGTGAGGTCGTTACAGGAGTCACTGTCGTATATCCTGTCCTTCAG
TCTCCTGGTTACGCCATTCGCCGCCGCCGGTGTANNNNNNNNNNNNNCTTTGCAGATAATCCAACTCATTTGTTGAAGGC
ATATGCGGACTGTGGAGAGGGTGTCGATCGCGCAGGCGGATTCGCGATTCAGGGACTGGGCTCACTGCTGATTCGTAAAA
TCGAGGGAGATTATAACAACGTGGTTGGATTTCCGGCAGCTTCATTCTTCAAGCTTCTTGATTTGATTTTGGAAGAGGAT
GAAGACTTTTTGAGCATGATAATCCCGGTATCTGCTGCAGATGGCAATACGACTGACAAAGAACGCCAGCGAGCGGCAAT
TTCTGCAGCGGCTAGAAATATGGATCGTGATGTCATAGTTGCTAAATATGACCTTCCATTGACCACCACCTTCCTCACCT
TGACCATTGACTCAGCACTGAAGCTTGAAGCTTACCATCACGATGAGCATGCCAACAGGAGATTCTTCATAGGTCCCATG
CCTGAAAGGGCTGTACCAGGCATAGACGCACTTGCTGCTTCAAAGAAGAAAGGAAAGCACCGCCTACTATACTACTCTGG
CGAAAATGAGGATGAGGCAGCTGTAGACCGCATCGTTCAAGAGAGTGCCTTCAGCTATTTCCTCAGTCGAGGTGGTCGGN
NNNNNGAAGAGNNNNNNNGACTGGNNNNGGCGTCGNNAGAGGAGATGAAACGTATATGGCGGGAAAGCCCATGGGGAGTC
TACCTGCAAAGCCGTCGGAACGACTCGACAAAGCGACCTGCAAATCGCTGGGTCGGAAGCAGTTTCGAGGTTGGAGAAAT
TGCTGGTTTCAATGTCATTCAAGAGGCAGACGCAATCACCTCTATGATTTCAAGCCGTACTTCGGCCTTCTCAGGCTCAA
ACACCAACTTTGCCGCTTCTACTCAGTACCTTCCCCTGGACGGCGCAGTAGAGCAGCTTAATTCACCTCCCAGGCCGACT
GTCACCACGACAAAGTCTTCTGGCCAGGATACCTTTTTCACGGCACGGTCAAGACTATCGTCGAGGACATCTAGCTCCAG
CAATGCTAGACCTAGTACGCCTCCAAAGGCGTCCATCAGCACACCAGTACCGGATGGCTCGCCTATCTCTGGTAACGGTA
CCCTTGCACTCAATGACTCACACAGTTCCTCAACAACGGCATTGCTGCCTTCTCCAACAATGCCCAGAATTGACTCAGCC
ATCAGTCAAACGCGTTCAGAGGCACCTCGTCGGCCTATCATAAAGCTGCCCTCTTTTGCCAAGAGTGACAGCGCACCTGT
CACGCAGAAGCCGGACAACAAAGGAAAGGGGAAAAAGGCGGTTCATTATGATCTGTCACCTATCACGCCATCTCCTACCG
GTGAACCAGCACCTCCCAGTGAGGTTTTGGAACGAGAGGGTGAAGAAGTGGAGGATACGAGTGCTGGTGCCATGAATACC
CCTACGACACCTACAGGAGATGCTGAAGTCAAGTGGGGAGCGATCGAGCTGAGAGTCATTCAAGACAGGATGCTTGTACG
CATAATCTCGTCTGACTTGACTGCTGTCCCGTCTTCCTTTGACGAGCAGAAACATCGCCAAACAAGGGATCTCAAGCATG
AGGGCTGGGGCGAGTTCATGGTTGTTTGGCGCGGTGACCGCGTTGAAGTATACGAAAACTATACAATCCCCGGGGAAGAG
TGGATAAGAGGCCACAAGAACTTATCCTATGTCATTCCCTTGAAGTCAGGGCGAACCAAACTGTCCATATACTCGTTCGT
CGACCTAACATTCTGCATAACATGTCCCCCGGTATCGAGACGTTACAATCCAGCTTCGAGGAAGTGGAAACTCACCGTTG
CGAAGCAAAAGACGATGGTGTATATCTTTAAGCTCAAGAGTCGTTCAAGGGCGTTTGATTGGGCATGGCAACTATGGCGT
CGGATCCAACCCTTAAATTCAAAACTACCGCCTTATGTGACTATTAAGAATCCCCGCCTCGACAGCAAAGTCAACATTGA
ATTACCGACTGATCCTGAACGACAGTATGCGGTATTCACCAGAGAGAACGTCGTCAATCTGTGCATCGAGAGCCTGAGTC
ATTTGCGGGACTTCCAGTACCTGGTTGAGCGACATAGGGCCGAAGGAAGGGTTTTCCAACTCGCTTGGAGGAGAGAGACG
CACTTGGATTGGATTTGGCTGGACGAAGACGTTGATGGTAGGCCCCGCGATTGGGCTGTTTTGTGTGGTTTGTTGATGCA
AGAATCCAGCGTTCCTGCACATCTGGAACTCCGACTCTGCCGACATTTCCCTAGCTTCATCCCCCTCAAAGATGGCAGCC
ATTTTTCAGAACCGTTGCCTATCGAAGGATACGTCGATCGAATCAAACCCGGCTCGGGAGCGAAGCAGCCTTTGTATCTC
GCCGTACATGACGGCAACCTCTTCGTACTGCATCCTTCTCATGCAAACCCGCCAGTCCCGCTAGGCGCTCTTCCTCGGAA
AGCGGGCACAATGGAATCATACATCGAGAACATGAAAAGATCTGAGGTTCAGAGGGGCGTCAAGCAAATCATGTTTGCTA
ATGGTGTTGCTGATTTAAGGAATGTTCTTGCCGTTAGACGAGCTATTCATCTTGTCATGCAATGTGACCATGATTACAAG
GATCGTCCAGAAGACGAGAACTGGATGAATGCTTGGTCTGAGGAAGAAACATTCCCAGCGGATTTCGAAGATACAGGCGG
AGAAGAGGCGTTGAATCAGACTTCGGATAAACACGACTTGAAGATGAGGCGTTCATTTGAACTCTTATTCAAAAATGGGC
ATGTCGTGAGATTCGAGGCTTATTCTTGCGCGTTTGCCATTGATTGGGTTCGTCGACTTCGGGAATTGGTGCACTACTGG
AGGCTTAAGCGTCGCTATGACGCTAAAGATGAAATGGATCTTGCTCAAGCACTGCGACCCCGTGTAACACCCAAGAGATA
TGCGGAACAGGACANNNNNNNNNGGATATGAGCACCTCCANATCTTTCGGCACCCCTTCCAGCCTTAGGATCTCTGTACA
ACTGGTGCATCGTGGACGGCTGTAGGCCGATACTCAGAGGGGGCAAGTTGTTTTCAAGACGTGGATTCAATGGGCAATAC
CGACTGGTGCAGATGTTCCTTTTGCCAGAGTATCTTGTTCAATTTCACATCAAACCCCAATCACAACTTCATCTGTCAGA
GCCCAGGAAAATCCATCTCATAGACGCCTATGCTTGCTCCGGTTACTTCGCTGCTCAGAGACTACCACGAGGACAATATG
ACGCGAATGCTGAATGTGTTGCTCATCGTTATGAAGACGGGTTGGAGGCCGATGACCCTGACGAGGACAAACTCTTCATC
GTGTGGTACAAATCTCCCCCGAAGAACAAAGATCCACTCTCGGAAAATGGAACCACGCCACCGTTGGATGCGAAACGGAA
GGTGGCAGTTTTCCGGACGAGGAGTAAACTGGAAAGAGATGCCTGGTGTTGGGCGTTGAACTGTGCCATCGAGAAAATAG
TTCGTGAGCGCAAGGATAGGGAGACGAAGATGAGGGAAACTGGCGGATTGATGCAAATA

Mp4071
ATGTCGAATCACGTTCTATCTCATGCTCTACATGGCCTGCCTGTGATAAAGAAACTTAAAGGAAGAAAAATAGTCCTTGC
TTCGAACAGTCCTCGTCGGAAAGCCATTTTGGAAACACTCGGCCTTGCACCCGACATCGTTCCGTCAAAATTTGAGGAAG
ATCTTGGGACAGACTCGTTCCCCGACCTGCACGAGTACCCAGTGGCCACAGCTTCTCACAAAGCAGTGGAGGTTTACGAG
AGGCTTGTGACAGAAAACCCCGACGATGCGCCCGATCTAGTCATTGCTGCAGACACTATCGTGTTAACACACGCACAGCC
CTCAACATCTCAGACGGGTTATAGTGTGCTCCCTGAAATCACTCAAGAGCTATTGGAGAAACCAAAGGATAAGGAAGATA
ACCTNNNNNACGGATGGGATATGAATGGGAGTGTATGTGAGGTCGTTACAGGAGTCACTGTCGTATATCCTGTCCTTCAG
TCTCNTGGTTACGCCANNNNNNNNNNNNNNNNNNNNNNNNNNNNNNNCTTTGCAGNTANTCCANCTCNTTTGTTGAAGGN
ATNTGCGGACTGTGGAGAGGGTGTCGATCGCGCAGGCGGATTCGCGATTCAGGGACTGGGCTCACTGTTGATTCGTAAAA
TCGAGGGAGATTATAACAACGTGGTTGGATTTCCGGCAGCTTCATTCTTCAAGCTTCTTGATTTGATTTTGGAAGAGGAT
GAAGACTTTTTGAGCATGATAATCCCGGTATCTGCTGCAGATGGCAATACGACTGACAAAGAACGCCAGCGAGCGGCAAT
TTCTGCAGCGGCTAGAAATATGGATCGTGATGTCATAGTTGCTAAATATGACCTTCCATTGACCACCNNNTTCCTCACCT
TGACCATTGACTCAGCACTGAAGCTTGAAGCTTACCATCACGATGAGCNTGCCAACAGGAGATTCTTCATAGGTCCCATG
CCTGAAAGGGCTGTACNAGGCATAGACGCACTTGCTGCTTCAAAGAAGAAAGGAAAGCACCGCCTACTATACTACTCTGG
CGAAAATGAGGATGAGGCAGCTGTAGACCGCATCGTTCAAGAGAGTGCCTTCAGCTATTTTCTCAGTCGAGGTGGTCGGN
NNNNNGAAGAGNNNNNNNGACTGGNNNNGGCGTCGNNAGAGGAGATGAAACGTATATGGCGGGAAAGCCCATGGGGAGTC
TACCTGCAAAGCCGTCGGAACGACTTGACAAAGCCACCTGCAAATCGCTGGGTCGGAAGCAGTTTCGAGGTTGGAGAAAT
TGCTGGTTTCAATGTCATTCAAGAGGCAGACGCAATCACCTCCATGATTTCGAGCCGTACTTCGGCCTTCTCAGGCTCAA
ACACCAACCTTGCCACTTCTACTCAGTATCTTCCGCTGGATGCCGCAGTAGAGCAGCTTAATTCACCTCCCAGGCCGACT
GTCACCACGACAAAGTCTTCTGGCCAGGATACCTTTTTCACAGCGCGGTCGAGACTATCGTCGAGGACATCTAGCTCCAA
CAATGCTAGACCTAGTACGCCTCCGAAGGCGTCCATCAGCACACCAGTACCAGATGGCTCGCCTATCTCTGGTAACGGTA
CCCTTGCACTCAATGACTCACACAGTTCCTCNNNNNNNNNNNNNNNNNNNNNNNNNNNNNNNNNNNNNNNNNNNNNNNNN
NNNNNNNNNNNNNNNNNNNNNNNNNNNNNNNNNNNNNNNNNNNNNNNNNNNNNTTNTGNNANGAGTGACAGCGCACCTGT
CACGCAGAAGCCGGACAACAAAGGAAAGGGGAAAAAGGCAGTTCATTATGATCTGTCGCCTATCACGCTATCTCCTACCG
GTGAACCAGCACCTCCCAGTGAGGTTTTGGAACGAGAGGGTGAAGAAGTGGAGGATACGAGTGCTGGTGCCATGAATACC
CCTACGACACCTACAGGAGATGCTGAAGTCAAGTGGGGAGCGATCGAGCTGAGAGTCATTCAAGACAGGATGCTTGTACG
CATAATCTCGTCTGACTTGACTGCTGTCCCGTCTTCCTTTGACGAGCAGAAACATCGCCAAACAAGAGATCTCAAGCATG
AGGGCTGGGGCGAGTTCATGGTTGTTTGGCGCGGTGACCGCGTTGAAGTATACGAAAACTATACAATCCCCGGGGAAGAG
TGGATAAGAGGCCACAAGAACTTATCCTATGTCATTCCCTTGAAGTCAGGGCGAACCAAACTGTCCATATACTCGTTCGT
CGACCTAACATTATGCATAACATGTCCCCCGGTATCGAGACGTTACAATCCAGCTTCGAGGAAGTGGAAACTCACCGTTG
CGAAGCAAAAGACGATGGTGTATATCTTTAAGCTCAAGAGTCGTTCAAGGGCGTTNNANTNGNCATGGNNNNNNNNNNNN
NNGATCCAACCCTTAAATTCAAAACTACCGCCTTATGTNACTATTAAGAATCCCCGCCTCGACAGCAAAGTCAACATTGA
ATTACCGACGGATCCTGAGCGACAGTATGCGGTATTCACCAGAGAGAACGTCGTCAATCTGTGCATCGAGAGCCTGAGTC
ATTTGCGGGACTTCCAGTACCTGGTTGAGCGACATAGGGCCGAAGGAAGGGTTTTCCAACTCGCTTGGAGGAGAGAGACG
CACTTGGATTGGATTTGGCTGGACGAAGACGTTGATGGTAGGCCCCGCGATTGGGCTGTTTTGTGTGGTTTGTTGATGCA
AGAATCCAGCGTTCCTGCACATCTGGAACTCCGACTCTGCCGACATTTCCCTAGCTTCATCCCCCTCAAAGATGGCAGCC
ATTTTTCAGAACCGTTGCCTATCGAAGGATACGTCGATCGAATCAAACCCGGCTCGGGAGCGAAGCAGCCTTTGTATCTC
GCCGTACATGACGGCACCCTCTTCGTACTGCATCCTTCTCATGCAAACCCGCCAGTCCCGCTAGGCGCTCTTCCTCGGAA
AGCGGGCACAATGGAATCATACATCGAGAACATGAAAAGATCTGAGGTTCAGAGGGGCGTCAAGCAAATCATGTTTGCTA
ATGGTGTTGCTGATTTAAGGAATGTTCTTGCCGTTAGACGAGCTATTCATCTTGTCATGCAACGTGACCATGATTACAAG
GATCGTCCAGAAGACGAGAACTGGATGAATGCTTGGTCTGAGGAAGAAACATCCCCAGCGGATTTCGAAGATACAGGCGG
AGAAGAGGCGTTGAATCAGACTTCGGATAAACACGACTTGAAGATGAGGCGTTCATTTGAACTCTTATTCAAAAATGGGC
ATGTCGTGAGATTCGAGGCTTATTCTTGCGCGTTTGCCATTGATTGGGTTCGTCGACTTCGGGAATTGGTGCACTACTGG
AGGCTTAAGCGTCGCTATGACGCTAAAGATGAAATGGATCTTGCTCAAGCACTGCGACCCCGTGTAACACCCAAGAGATA
TGCGGAACAGGACNNNNNNNNNNNNNNNNNAGCACCTCCAGATCTTTCGGCACCCCTTCCAGCCTTAGGATCTCTGTACA
ACTGGTGCATCGTGGACGGCTGTAGGCCGATACTCAGAGGGGGCAAGTTGTTTTCAAGACGTGGATTCAATGGGCAATAC
CGACTGGTGCAGATGTTCCTTTTGCCAGAGTATCTTGTTCAATTTCACATCAAACCCCAATCACAACTTCATCTGTCAGA
GCCCAGGAAAATCCATCTCATAGACGCCTATGCTTGCTCCGGTTACTTCGCTGCTCAGAGACTACCACGAGGACAATATG
ACGCGAATGCTGAATGTGTTGCTCATCGTTATGAAGACGGGTTGGAGGCCGATGACCCTGACGAGGACAAACTCTTCATC
GTGTGGTACAAATCTCCCCCGAAGAACAAAGATCCACTCTCGGAAGATGGAACCACGCCACCGTTGGACGCGAAACGGAA
GGTGGCAGTTTTCCGGACGAGGAGTAAACTGGAAAGAGATGCCTGGTGTTGGGCGTTGAACTGTGCCATCGAGAAAATAG
TTCGTGAGCGCAAGGATAGGGAGACGAAGATGAGGGAAACTGGCGGATTGATGCAAATA

Mp4124
ATGTCGAATCACGTTCTATCTCATGCTCTACATGGCCTGCCTGTGATAAAGAAACTTAAAGGAAGAAAAATAGTCCTTGC
TTCGAACAGTCCTCGTCGGAAAGCCATTTTGGAAACACTCGGCCTTGCACCCGACATCGTTCCGTCAAAATTTGAGGAAG
ATCTTGGGACAGACTCGTTCCCCGACCTGCACGAGTACCCAGTGGCCACAGCTTCTCACAAAGCAGTGGAGGTTTACGAG
AGGCTTGTGACAGAAAACCCCGACGATGCGCCCGATCTAGTCATTGCTGCAGACACTATCGTGTTAACACACGCACAGCC
CTCAACATCTCAGACGGGTTATAGTGTGCTCCCTGAAATCACTCAAGAGCTATTGGAGAAACCAAAGGATAAGGAAGATA
ACCNCGNNGATGNATGGNNTANGNATNGGAGTGTANGTGAGGTCGTTACAGGAGTNACTGTCGTATATCCTGTCCTTNAG
TCTCCTGGNTACNCNATTCGCNNNNNNNNNNNNNNNNNNNNNNNNNNCTTTGCAGATAATCCAACTCATTTGTTGAAGGC
ATATGCGGACTGTGGAGAGGGTGTCGATCGCGCAGGCGGATTCGCGATTCAGGGACTGGGCTCACTGTTGATTCGTAAAA
TCGAGGGAGATTATAACAACGTGGTTGGATTTCCGGCAGCTTCATTCTTCAAGCTTCTTGATTTGATTTTGGAAGAGGAT
GAAGACTTTTTGAGCATGATAATCCCGGTATCTGCTGCAGATGGCAATACGACTGACAAAGAACGCCAGCGAGCGGCAAT
TTCTGCAGCGGCTAGAAATATGGATCGTGATGTCATAGTTGCTAAATATGACCTTCCATTGACCACCANCTTCCTCACCT
TGACCATTGACTCAGCACTGAAGCTTGAAGCTTACCATCACGATGAGCATGCCAACAGGAGATTCTTCATAGGTCCCATG
CCTGAAAGGGCTGTACCAGGCATAGACGCACTTGCTGCTTCAAAGAAGAAAGGAAAGCACCGCCTACTATACTACTCTGG
CGAAAATGAGGATGAGGCAGCTGTAGACCGCATCGTTCAAGAGAGTGCCTTCAGCTATTTTCTCAGTCGAGGTGGTCGGN
NNNNNGAAGAGNNNNNNNGACTGGNNNNGGCGTCGNNAGAGGAGATGAAACGTATATGGCGGGAAAGCCCATGGGGAGTC
TACCTGCAAAGCCGTCGGAACGACTTGACAAAGCCACCTGCAAATCGCTGGGTCGGAAGCAGTTTCGAGGTTGGAGAAAT
TGCTGGTTTCAATGTCATTCAAGAGGCAGACGCAATCACCTCCATGATTTCGAGCCGTACTTCGGCCTTCTCAGGCTCAA
ACACCAACCTTGCCACTTCTACTCAGTATCTTCCGCTGGATGCCGCAGTAGAGCAGCTTAATTCACCTCCCAGGCCGACT
GTCACCACGACAAAGTCTTCTGGCCAGGATACCTTTTTCACAGCGCGGTCGAGACTATCGTCGAGGACATCTAGCTCCAA
CAATGCTAGACCTAGTACGCCTCCGAAGGCGTCCATCAGCACACCAGTACCAGATGGCTCGCCTATCTCTGGTAACGGTA
CCCTTGCACTCAATGACTCACACAGTTCCTCAACAACGGCATTGCTGCCTTCTCCAACAATGCCCAGAATTGACTCAGCC
ATCAGTCAAACGCGTTCAGAGGCACCTCGTCGGCCTATCATAAAGCTGCCCTCTTTTGCCAAGAGTGACAGCGCACCTGT
CACGCAGAAGCCGGACAACAAAGGAAAGGGGAAAAAGGCAGTTCATTATGATCTGTCGCCTATCACGCTATCTCCTACCG
GTGAACCAGCACCTCCCAGTGAGGTTTTGGAACGAGAGGGTGAAGAAGTGGAGGATACGAGTGCTGGTGCCATGAATACC
CCTACGACACCTACAGGAGATGCTGAAGTCAAGTGGGGAGCGATCGAGCTGAGAGTCATTCAAGACAGGATGCTTGTACG
CATAATCTCGTCTGACTTGACTGCTGTCCCGTCTTCCTTTGACGAGCAGAAACATCGCCAAACAAGAGATCTCAAGCATG
AGGGCTGGGGCGAGTTCATGGTTGTTTGGCGCGGTGACCGCGTTGAAGTATACGAAAACTATACAATCCCCGGGGAAGAG
TGGATAAGNGGCCACAAGAACTTATCCTATGTCATTCCCTTGAAGTCAGGGCGAACCAAACTGTCCATATACTCGTTCGT
CGACCTAACATTATGCATAACATGTCCCCCGGTATCGAGACGTTACAATCCAGCTTCGAGGAAGTGGAAACTCACCGTTG
CGAAGCAAAAGACGATGGTGTATATCTTTAAGCTCAAGAGTCGTTCAAGGGCGTTTGATTGGGCATGGCAACTATGGTGT
CGGATCCAACCCTTAAATTCAAAACTACCGCCTTATGTGACTATTAAGAATCCCCGCCTCGACAGCAAAGTCAACATTGA
ATTACCGACTGATCCTGAGCGACAGTATGCGGTATTCACCAGAGAGAACGTCGTCAATCTGTGCATCGAGAGCCTGAGTC
ATTTGCGGGACTTCCAGTACCTGGTTGAGCGACATAGGGCCGAAGGAAGGGTTTTCCAACTCGCTTGGAGGAGAGAGACG
CACTTGGATTGGATTTGGCTGGACGAAGACGTTGATGGTAGGCCCCGCGATTGGGCTGTTTTGTGTGGTTTGTTGATGCA
AGAATCCAGCGTTCCTGCACATCTGGAACTCCGACTCTGCCGACATTTCCCTAGCTTCATCCCCCTCAAAGATGGCAGCC
ATTTTTCAGAACCGTTGCCTATCGAAGGATACGTCGATCGAATCAAACCCGGCNNNNNNNNNNNNNNNNNNNNNNNNNNC
NNCGTANATGNCGGCAACCTCTTCGTACTGCATCCTTCTCATGCAAACCCGCCAGTCCCGCTAGGCGCTCTTCCTCGGAA
AGCGGGCACAATGGAATCATACATCGAGAACATGAAAAGATCTGAGGTTCAGAGGGGCGTCAAGCAAATCATGTTTGCTA
ATGGTGTTGCTGATTTAAGGAATGTTCTTGCCGTTAGACGAGCTATTCATCTTGTCATGCAACGTGACCATGATTACAAG
GATCGTCCAGAAGACGAGAACTGGATGAATGCTTGGTCTGAGGAAGAAACATCCCCAGCGGATTTCGAAGATACAGGCGG
AGAAGAGGCGTTGAATCAGACTTCGGATAAACACGACTTGAAGATGAGGCGTTCATTTGAACTCTTATTCAAAAATGGGC
ATGTCGTGAGATTCGAGGCTTATTCTTGCGCGTTTGCCATTGATTGGGTTCGTCGACTTCGGGAATTGGTGCACTACTGG
AGGCTTAAGCGTCGCTATGACGCTAAAGATGAAATGGATCTTGCTCAAGCACTGCGACCCCGTGTAACACCCAAGAGATA
TGCGGAACAGGACANNNNNNNNNGGATATGAGCACCTCCAGATCTTTCGGCACCCCTTCCAGCCTTAGGATCTCTGTACA
ACTGGTGCATCGTGGACGGCTGTAGGCCGATACTCAGAGGGGGCAAGTTGTTTTCAAGACGTGGATTCAATGGGCAATAC
CGACTGGTGCAGATGTTCCTTTTGCCAGAGTATCTTGTTCAATTTCACATCAAACCCCAATCACAACTTCATCTGTCAGA
GCCCAGGAAAATCCATCTCATAGACGCCTATGCTTGCTCCGGTTACTTCGCTGCTCAGAGACTACCACGAGGACAATATG
ACGCGAATGCTGAATGTGTTGCTCATCGTTATGAAGACGGGTTGGAGGCCGATGACCCTGACGAGGACAAACTCTTCATC
GTGTGGTACAAATCTCCCCCGAAGAACAAAGATCCACTCTCGGAAGATGGAACCACGCCACCGTTGGACGCGAAACGGAA
GGTGGCAGTTTTCCGGACGAGGAGTAAACTGGAAAGAGATGCCTGGTGTTGGGCGTTGAACTGTGCCATCGAGAAAATAG
TTCGTGAGCGCAAGGATAGGGAGACGAAGATGAGGGAAACTGGCGGATTGATGCAAATA

Mp4145
ATGTCGAATCACGTTCTATCTCATGCTCTACATGGCCTGCCTGTGATAAAGAAACTTAAAGGAAGAAAAATAGTCCTTGC
TTCGAACAGTCCTCGTCGGAAAGCCATCTTGGAAACACTCGGCCTTGCACCCGACATCGTTCCGTCAAAATTTGAGGAAG
ATCTTGGGACAGACTCGTTCCCCGACCTGCACGAGTACCCAGTGGCCACAGCTTCTCACAAAGCAGTGGAGGTTTACGAG
AGGCTTGTGACAGAAAACCCCGACGATGCGCCCGATCTAGTCATTGCTGCAGACACTATCGTGTTAACACACGCACAGCC
CTCAACATCTCAGACGGGTTATAGTGTGCTCCCTGAAATCACTCAAGAGCTATTGGAGAAACCAAAGGATAAGGAAGATA
ACCTNGGATACGGATGGGATATGAATGGGAGTGTATGTGAGGTCGTTACAGGAGTCACTGTCGTTTATCCTGTCCTTCAG
TCTCCTGGTTACGCCATTCGCCGACGCCGGTGTANNNNNNNNNNNNNCTTTGCAGATAATCCAACTCATTTGTTGAAGGC
ATATGCGGACTGTGGAGAGGGTGTCGATCGCGCAGGCGGATTCGCGATTCAGGGACTGGGCTCACTGCTGATTCGTAAAA
TCGAGGGAGATTATAACAACGTGGTTGGATTTCCGGCAGCTTCATTCTTCAAGCTTCTTGATTTGATTTTGGAAGAGGAT
GAAGACTTTTTGAGCATGATAATCCCGGTATCTGCTGCAGATGGCAATACGACTGACAAAGAACGCCAGCGAGCGGCAAT
TTCTGCAGCGGCTAGAAATATGGATCGTGATGTCATAGTTGCTAAATATGACCTTCCATTGACCACCACCTTCCTCACCT
TGACCATTGACTCAGCACTGAAGCTTGAAGCTTACCATCACGATGAGCATGCCAACAGGAGATTCTTCATAGGTCCCATG
CCTGAAAGGGCTGTACCAGGCATAGACGCACTTGCTGCTTCAAAGAAGAAAGGAAAGCACCGCCTACTATACTACTCTGG
CGAAAATGAGGATGAGGCAGCTGTAGACCGCATCGTTCAAGAGAGTGCCTTCAGCTATTTCCTCAGTCGAGGTGGTCGGG
NNNNNGAAGAGNNNNNNNGACTGGNNNNGGCGTCGNNAGAGGAGATGAAACGTATATGGCGGGAAAGCCCATGGGGAGTC
TACCTGCAAAGCCGTCGGAACGACTCGACAAAGCGACCTGCAAATCGCTGGGTCGGAAGCAGTTTCGAGGTTGGAGAAAT
TGCTGGTTTCAATGTCATTCAAGAGGCAGACGCAATCACCTCCATGATTTCAAGCCGTACTTCGGCCTTCTCAGGCTCAA
ACACCAACTTTGCCGCTTCTACTCAGTACCTTCCCCTGGACGGCGCAGTAGAGCAGCTTAATTCACCTCCCAGGCCGACT
GTCACCACGACAAAGTCTTCTGGCCAGGATACCTTTTTCACGGCACGGTCAAGACTATCGTCGAGGACATCTAGCTCCAG
CAATGCTAGACCTAGTACGCCTCCAAAGGCGTCCATCAGCACACCAGTACCGGATGGCTCGCCTATCTCTGGTAACGGTA
CCCTTGCACTCAATGACTCACACAGTTCCTCAACAACGGCATTGCTGCCTTCTCCAACAATGCCCAGAATTGACTCAGCC
ATCAGTCAAACGCGTTCAGAGGCACCTCGTCGGCCTATCATAAAGCTGCCCTCTTTTGCCAAGAGTGACAGCGCACCTGT
CACGCAGAAGCCGGACAACAAAGGAAAGGGGAAAAAGGCGGTTCATTATGATCTGTCACCTATCACGCCATCTCCTACCG
GTGAACCAGCACCTCCCAGTGAGGTTTTGGAACGAGAGGGTGAAGAAGTGGAGGATACGAGTGCTGGTGCCATGAATACC
CCTACGACACCTACAGGAGATGCTGAAGTCAAGTGGGGAGCGATCGAGCTGAGAGTCATTCAAGACAGGATGCTTGTACG
CATAATCTCGTCTGACTTGACTGCTGTCCCGTCTTCCTTTGACGAGCAGAAACATCGCCAAACAAGGGATCTCAAGCATG
AGGGCTGGGGCGAGTTCATGGTTGTTTGGCGCGGTGACCGCGTTGAAGTATACGAAAACTATACAATCCCCGGGGAAGAG
TGGATAAGAGGCCACAAGAACTTATCCTATGTCATTCCCTTGAAGTCAGGGCGAACCAAACTGTCCATATACTCGTTCGT
CGACCTAACATTCTGCATAACATGTCCCCCGGTATCGAGACGTTACAATCCAGCTTCGAGGAAGTGGAAACTCACCGTTG
CGAAGCAAAAGACGATGGTGTATATCTTTAAGCTCAAGAGTCGTTCAAGGGCGTTTGATTGGGCATGGCAACTATGGCGT
CGGATCCAACCCTTAAATTCAAAACTACCGCCTTATGTGACTATTAAGAATCCCCGCCTCGACAGCAAAGTCAACATTGA
ATTACCGACTGATCCTGAACGACAGTATGCGGTATTCACCAGAGAGAACGTCGTCAATCTGTGCATCGAGAGCCTGAGTC
ATTTGCGGGACTTCCAGTACCTGGTTGAGCGACATAGGGCCGAAGGAAGGGTTTTCCAACTCGCTTGGAGGAGAGAGACG
CACTTGGATTGGATTTGGCTGGACGAAGACGTTGATGGTAGGCCCCGCGATTGGGCTGTTTTGTGTGGTTTGTTGATGCA
AGAATCCAGCGTTCCTGCACATCTGGAACTCCGACTCTGCCGACATTTCCCTAGCTTCATCCCCCTCAAAGATGGCAGCC
ATTTTTCAGAACCGTTGCCTATCGAAGGATACGTCGATCGAATCAAACCCGGCTCGGGAGCGAAGCAGCCTTTGTATCTC
GCCGTACATGACGGCAACCTCTTCGTACTGCATCCTTCTCATGCAAACCCGCCAGTCCCGCTAGGCGCTCTTCCTCGGAA
AGCGGGCACAATGGAATCATACATCGAGAACATGAAAAGATCTGAGGTTCAGAGGGGCGTCAAGCAAATCATGTTTGCTA
ATGGTGTTGCTGATTTAAGGAATGTTCTTGCCGTTAGACGAGCTATTCATCTTGTCATGCAATGTGACCATGATTACAAG
GATCGTCCAGAAGACGAGAACTGGATGAATGCTTGGTCTGAGGAAGAAACATTCCCAGCGGATTTCGAAGATACAGGCGG
AGAAGAGGCGTTGAATCAGACTTCGGATAAACACGACTTGAAGATGAGGCGTTCATTTGAACTCTTATTCAAAAATGGGC
ATGTCGTGAGATTCGAGGCTTATTCTTGCGCGTTTGCCATTGATTGGGTTCGTCGACTTCGGGAATTGGTGCACTACTGG
AGGCTTAAGCGTCGCTATGACGCTAAAGATGAAATGGATCTTGCTCAAGCACTGCGACCCCGTGTAACACCCAAGAGATA
TGCGGAACAGGACANNNNNNNNNGGATATGAGCACCTCCAGATCTTTCGGCACCCCTTCCAGCCTTAGGATCTCTGTACA
ACTGGTGCATCGTGGACGGCTGTAGGCCGATACTCAGAGGGGGCAAGTTGTTTTCAAGACGTGGATTCAATGGGCAATAC
CGACTGGTGCAGATGTTCCTTTTGCCAGAGTATCTTGTTCAATTTCACATCAAACCCCAATCACAACTTCATCTGTCAGA
GCCCAGGAAAATCCATCTCATAGACGCCTATGCTTGCTCCGGTTACTTCGCTGCTCAGAGACTACCACGAGGACAATATG
ACGCGAATGCTGAATGTGTTGCTCATCGTTATGAAGACGGGTTGGAGGCCGATGACCCTGACGAGGACAAACTCTTCATC
GTGTGGTACAAATCTCCCCCGAAGAACAAAGATCCACTCTCGGAAAATGGAACCACGCCACCGTTGGATGCGAAACGGAA
GGTGGCAGTTTTCCGGACGAGGAGTAAACTGGAAAGAGATGCCTGGTGTTGGGCGTTGAACTGTGCCATCGAGAAAATAG
TTCGTGAGCGCAAGGATAGGGAGACGAAGATGAGGGAAACTGGCGGATTGATGCAAATA

MrPeru
ATGTCGAATCACGTTCTATCTCATGCTCTACATGGCCTGCCTGTGATAAAGAAACTTAAAGGAAGAAAAATAGTCCTTGC
TTCGAACAGTCCTCGTCGGAAAGCCATCTTGGAAACACTCGGCCTTGCACCCGACATCGTTCCGTCAAAATTTGAGGAAG
ATCTTGGGACAGACTCGTTCCCCGACCTGCACGAGTACCCAGTGGCCACAGCTTCTCACAAAGCAGTGGAGGTTTACGAG
AGGCTTGTGACAGAAAACCCCGACGATGCGCCCGATCTAGTCATTGCTGCAGACACTATCGTGTTAACACACGCACAGCC
CTCAACNNNNNNNNNGGGTTATAGTGTGCTCCCTGAAATCACTCAAGAGCTATTGGAGAAACCAAAGGATAAGGAAGATA
ACCTNNNNNACGGATGGGATATGAATGGGAGTGTATGTGAGGTCGTTACAGGAGTCACTGTCGTATATCCTGTCCTTCAG
TCTCCTGGTTACGCCATTCGCCGACGCCGGTGTAGTTGGTGTANNNNCTTTGCAGATAATCCAACTCATTTGTTGAAGGC
ATATGCGGACTGTGGAGAGGGTGTCGATCGCGCAGGCGGATTCGCGATTCAGGGACTGGGCTCACTGCTGATTCGTAAAA
TCGAGGGAGATTATAACAACGTGGTTGGATTTCCGGCAGCTTCATTCTTCAAGCTTCTTGATTTGATTTTGGAAGAGGAT
GAAGACTTTTTGAGCATGATAATCCCGGTATCTGCTGCAGATGGCAATACGACTGACAAAGAACGCCAGCGAGCGGCAAT
TTCTGCAGCGGCTAGAAATATGGATCGTGATGTCATAGTTGCTAAATATGACCTTCCATTGACCACCNNNTTCCTCACCT
TGACCATTGACTCAGCACTGAAGCTTGAAGCTTACCATCACGATGAGCATGCCAACAGGAGATTCTTCATAGGTCCCATG
CCTGAAAGGGCTGTACCAGGCATAGACGCACTTGCTGCTTCAAAGAAGAAAGGAAAGCACCGCCTACTATACTACTCTGG
CGAAAATGAGGATGAGGCAGCTGTAGACCGCATCGTTCAAGAGAGTGCCTTCAGCTATTTCCTCAGTCGAGGTGGTCGGN
NNNNNGAAGAGNNNNNNNGACTGGNNNNGGCGTCGNNAGAGGAGATGAAACGTATATGGCGGGAAAGCCCATGGGGAGTC
TACCTGCAAAGCCGTCGGAACGACTCGACAAAGCGACCTGCAAATCGCTGGGTCGGAAGCAGTTTCGAGGTTGGAGAAAT
TGCTGGTTTCAATGTCATTCAAGAGGCAGACGCAATCACCTCTATGATTTCAAGCCGTACTTCGGCCTTCTCAGGCTCAA
ACACCAACTTTGCCGCTTCTACTCAGTACCTTCCCCTGGACGGCGCAGTAGAGCAGCTTAATTCACCTCCCAGGCCGACT
GTCACCACGACAAAGTCTTCTGGCCAGGATACCTTTTTCACGGCACGGTCAAGACTATCGTCGAGGACATCTAGCTCCAG
CAATGCTAGACCTAGTACGCCTCCAAAGGCGTCCATCAGCACACCAGTACCGGATGGCTCGCCTATCTCTGGTAACGGTA
CCCTTGCACTCAATGACTCACACAGTTCCTCAACAACGGCATTGCTGCCTTCTCCAACAATGCCCAGAATTGACTCAGCC
ATCAGTCAAACGCGTTCAGAGGCACCTCGTCGGCCTATCATAAAGCTGCCCTCTTTTGCCAAGAGTGACAGCGCACCTGT
CACGCAGAAGCCGGACAACAAAGGAAAGGGGAAAAAGGCGGTTCATTATGTTCTGTCACCTATCACGCCATCTCCTACCG
GTGAACCAGCACCTCCCAGTGAGGTTTTGGAACGAGAGGGTGAAGAAGTGGAGGATACGAGTGCTGGTGCCATGAATACC
CCTACGACACCTACAGGAGATGCTGAAGTCAAGTGGGGAGCGATCGAGCTGAGAGTCATTCAAGACAGGATGCTTGTACG
CATAATCTCGTCTGACTTGACTGCTGTCCCGTCTTCCTTTGACGAGCAGAAACATCGCCAAACAAGGGATCTCAAGCATG
AGGGCTGGGGCGAGTTCATGGTTGTTTGGCGCGGTGACCGCGTTGAAGTATACGAAAACTATACAATCCCCGGGGAAGAG
TGGATAAGAGGCCACAAGAACTTATCCTATGTCATTCCCTTGAAGTCAGGGCGAACCAAACTGTCCATATACTCGTTCGT
CGACCTAACATTCTGCATAACATGTCCCCCGGTATCGAGACGTTACAATCCAGCTTCGAGGAAGTGGAAACTCACCGTTG
CGAAGCAAAAGACGATGGTGTATATCTTTAAGCTCAAGAGTCGTTCAAGGGCGTTTGATTGGGCATGGCAACTATGGCGT
CGGATCCAACCCTTAAATTCAAAACTACCGCCTTATGTGACTATTAAGAATCCCCGCCTCGACAGCAAAGTCAACATTGA
ATTACCGACTGATCCTGAACGACAGTATGCGGTATTCACCAGAGAGAACGTCGTCAATCTGTGCATCGAGAGCCTGAGTC
ATTTGCGGGACTTCCAGTACCTGGTTGAGCGACATAGGGCCGAAGGAAGGGTTTTCCAACTCGCTTGGAGGAGAGAGACG
CACTTGGATTGGATTTGGCTGGACGAAGACGTTGATGGTAGGCCCCGCGATTGGGCTGTTTTGTGTGGTTTGTTGATGCA
AGAATCCAGCGTTCCTGCACATCTGGAACTCCGACTCTGCCGACATTTCCCTAGCTTCATCCCCCTCAAAGATGGCAGCC
ATTTTTCAGAACCGTTGCCTATCGAAGGATACGTCGATCGAATCAAACCCGGCTCGGGAGCGAAGCAGCCTTTGTATCTC
GCCGTACATGACGGCAACCTCTTCGTACTGCATCCTTCTCATGCAAACCCGCCAGTCCCGCTAGGCGCTCTTCCTCGGAA
AGCGGGCACAATGGAATCATACATCGAGAACATGAAAAGATCTGAGGTTCAGAGGGGCGTCAAGCAAATCATGTTTGCTA
ATGGTGTTGCTGATTTAAGGAATGTTCTTGCCGTTAGACGAGCTATTCATCTTGTCATGCAATGTGACCATGATTACAAG
GATCGTCCAGAAGACGAGAACTGGATGAATGCTTGGTCTGAGGAAGAAACATTCCCAGCGGATTTCGAAGATACAGGCGG
AGAAGAGGCGTTGAATCAGACTTCGGATAAACACGACTTGAAGATGAGGCGTTCATTTGAACTCTTATTCAAAAATGGGC
ATGTCGTGAGATTCGAGGCTTATTCTTGCGCGTTTGCCATTGATTGGGTTCGTCGACTTCGGGAATTGGTGCACTACTGG
AGGCTTAAGCGTCGCTATGACGCTAAAGATGAAATGGATCTTGCTCAAGCACTGCGACCCCGTGTAACACCCAAGAGATA
TGCGGAACAGGACANNNNNNNNNGGATATGAGCACCTCCAGATCTTTCGGCACCCCTTCCAGCCTTAGGATCTCTGTACA
ACTGGTGCATCGTGGACGGCTGTAGGCCGATACTCAGAGGGGGCAAGTTGTTTTCAAGACGTGGATTCAATGGGCAATAC
CGACTGGTGCAGATGTTCCTTTTGCCAGAGTATCTTGTTCAATTTCACATCAAACCCCAATCACAACTTCATCTGTCAGA
GCCCAGGAAAATCCATCTCATAGACGCCTATGCTTGCTCCGGTTACTTCGCTGCTCAGAGACTACCACGAGGACAATATG
ACGCGAATGCTGAATGTGTTGCTCATCGTTATGAAGACGGGTTGGAGGCCGATGACCCTGACGAGGACAAACTCTTCATC
GTGTGGTACAAATCTCCCCCGAAGAACAAAGATCCACTCTCGGAAAATGGAACCACGCCACCGTTGGATGCGAAACGGAA
GGTGGCAGTTTTCCGGACGAGGAGTAAACTGGAAAGAGATGCCTGGTGTTGGGCGTTGAACTGTGCCATCGAGAAAATAG
TTCGTGAGCGCAAGGATAGGGAGACGAAGATGAGGGAAACTGGCGGATTGATGCAAATA
