 6 3303
Mp1441
ATGTCTCAGTTAGGCCCTGGGGTGGCTGATGCGCAGGCGTCTGCTAATCTCCAGCAGGGGACCACGTCTCTAGCTGCTAT
CACGCTTGCTTCAAACGCTGGGAAGCGTCCACCATGGAAGAGACGAAAACTGGACCCTAAGATGATCGAATCTTTGGCAT
TGCTAGGCTCGGACTCTTCGACGCAAGAAGCAGCCGTGGTGGAACCTGTAAATCAACAGATGGGCAAGGAGAACATGGTT
ATACAACCTTGTATCTCACCTCCGGTGAACAGAGACGTTTCTGATTCGGATATTCAACCGAATCGCCGACCGGCCGCTGA
CCCACATACCGGTGCTTCACCACAGCAACCAATACAAAATCTGCCTCATCCTCAAATGTCTGTCCGTCATGGGACTGTCT
ACCATCCCCCACATTCGTTTTCGCCTATTCGAGTGTGTAATATTTATGGGTGTGGCGTGGTTCTGACCTCGCAGAAGGAT
GGCGATGGACCAGTGTGTCAGAGCCATCGCATGGACATGGAGAGTATCCGTCGAGTCAACCAGACGTCAGGGAACAGAGG
TATTCCTTCTTCGATTGCGTTTGGTTTGGCACTTCGTCGCGCAGCTGCGGAACCGCAACGACAGCAGAAAGGGCCTGCTC
CGGGCCCTTCCCATGAGAAACGCGCTGCGGCTGGTGACCCCCGAAGCCCTAGGCACGTACATGTGAGATCTTCCATAAAT
ATGGACAAGGGTAAACACCCGAAAGAAACGACNGACTATACTAACATGGATTTAGTGNGAGCCGTCNGAAAAGCCGTTTC
TAATGTTGTGTCAACGATGCGAGCTGAAGGCTTCAACCTCGAATTNACATATCCTCTAACAGAAGCGGAAACTGCATTAT
ATCGGAGGGAATCCAGGATCGCCAAAACGTCGGGACCTCCATCAAATTACCCTCCGATACCTTACTCGCCAAAAACTTTG
GCACCGCCGCCATCGTCACAACNNCCTCCNCTNCCANTTNCCACTGTACATCTCNCCTCAANCGGGGCAGGTACGAAAGA
ACGATTAGAGATTGTCGATCTCACAATTGGTGAGGACGACAAGCCTTCAACATCAAAGACAGGCAGAGGTTCGCAATTGC
CTAAGTCTGGTGTTCCTACTACTGCCAGCAGAACGAATGACTTCAGCCCATATCCAGCGGACCACCTTCCCCGTCAAGGC
GATTATACCTATCCCCGCCCTNTTGTTCCAGGCCAAGCTCAAGCTTTTCATCCTCAGCTACCATCGCAAACTCCAAGGCA
TTTAGCTCCTCGAATGCGAACCTGTACCACTCCCGGCTGTACAGGTCTCATCAAGCCCGATAGCGCTGCAAAGCGTTGCT
ATGGATGTGTTATGTCGAACTGGAAAGCTCGCAGGCCTGTGTTTATTTCAACGCAGGCAGATGTGGGAGCGAATACCAGT
TCGGATAAAGCGGGCAGTGAACCCCCTGGTGTCGTAGATCAGCAACGAGATAATAGTGGCCCATCAACTAAGAAACGAAA
GAGCGTTACATGGGCTGACGGATGGAATCCCGGTGAAGATGTAGTAGAGAATGTAGAGATGACCACAGTCCAAGAACCGC
AAGCCTCTGAGCAGGCAGCAGAGGCGGAAGAAGAAGACGCCATTGCGGGATGGGATAGCGATTTGACGGACCTGGAAGGC
TCGACCACGAGTGAAGAAAGCAACTCACAGGACGGCGAAAGTAGTGATTCGGATACTTCAAGTGCTTCCGACACACCACT
TGCGTGTAAACCAATACGAACTGGATTTAAAATCCGTATACCTCCCAGACCTAGACCACAATCGCAACATGCGCCGTCAC
CATTACCTCGAGTCCGGCTAATACTTTCCAGACCGCCTACTTCATCCTCTATCCCGANNNNNNNNNNNNNNNGTATGGCA
GCCTCTCTATCCTCCTCCTCCGCTCCCTTTCCGGCGTCCACACCCTCTGTTTCTGGAGAAGCAAAACCTTCGGCTCAAGA
TGCGCCTGATCCTCGCTGCGTCACTAAAGCGTGCGGTGCACCTTTACCCTCTGGGTACGCCTGGAAATGTTGTCCAGAAT
GCCGTGCTCGTACTCGGAAATATCAACTTGGGTACCAGGAGCAATATGTTGAAGCCCAGAACGGTCGTCAAAAGGACGTA
AGCATTCCCCATCCAGTGACCGCTGCTAGCTCCCCAAAGACCGTTAAGCAGATTGACAGTACCTCCATTGCGAAAGCAGG
CCTGCCCATCAAGCTTCCTCTCAGGGTTTGCAGTGTCAGTGGGTCTGACGCTACTTTGGTAGACCCTCGAGGCCTTCTGG
TGTCCCAAGCGAGGCTCTGCATAATCAAGAACTGCAAACATATTCTTCCGGCGGTGGCTGAGTATCAGTGGGATATGTGT
CATCCTTGTCGGGAAAGGACCACCAGGACCAGACAAATCAAGCAAATAAAGGCCACTCAAGGAACAAATGCAGAGGAAAT
GATTCGAGGACTTAATGCAACGCCTCCGCAGCCTACGCCACAATGTCCAGGCCGCTTTGCAAGGTGTATATACATCGATT
GTGGCATCCGATTGGATCCTCATCGCTGCAATCAGGAATGTGGACAGTGCCGTTGGAGGAAGCTTCCCCCGGAAAGGAGA
AAAACCGCGACGCTTCCTTTACATGATCATGTATTCGTCCTCACGACAGAGGTCACGAAACATACTACTACCGCTGAAGT
AGCATTCAATGAAACGTTCAAATCTTCCACACCCGAAACGGTAGATTCATTTCATGGTACCACTCCAACCCATCCGGTCC
CTATTCCACCTGACAAGCCACGTCCACCGACCCTATACCCAGAATATACCTCCCTCTCTCGTCTGCTTGCCAATTTTCCC
TACTGNNNNNNNNNNNNNNNCAGTTTCTACANNNNNAGCGCAGTCCTTAAGGGCTCTAGAAATCCTGCTAAATTTGGGTT
CGATGGCGAGTACTCTATTGTCGCGGCTAATCTCGATGTAAAGGGCAGGGAGCAAGAGGTAGTGATGTCAGTCACAAACG
TAATGCAAGAGATTGAGAGGGTGGGGCAGCTGCGATTTGAATGCGTGTTGTCCAGTCCTCAAAGCCGAGTCTCCTCATTT
GCGTTCGGCGGAATTATTACCCGTTTCAACTGCCAACAAAACATTACATTAGCAATACAACCACAGACTCAGCCACCACC
TATAAGNACTATNATAGGANANTTGGANATNNNNNNNNNNNNNNNNNNNNNNNNNNNNNNNNNNNNNNNNNNNNNNNNNN
NNNNNNNNNNNNNNNNNNNNNNN

Mp178
ATGTCTCAGTTAGGCCCTGGGGTGGCTGATGCGCAGGCGTCTGCTAATCTCCAGCAGGGGACCACGTCTCTAGCTGCTAT
CACGCTTGCTTCAAACGCTGGGAAGCGTCCACCATGGAAGAGACGAAAACTGGACCCTAAGATGATCGAATCTTTGGCAT
TGCTAGGCTCGGACTCTTCGACGCAAGAAGCAGCCGTGGTGGAACCTGTAAATCAACAGATGGGCAAGGAGAACATGGTT
ATACAACCTTGTATCTCACCTCCGGTGAACAGAGACGTTTCTGATTCGGATATTCAACCGAATCGCCGACCGGCCGCTGA
CCCACATACCGGTGCTTCACCACAGCAACCAATACAAAATCTGCCTCATCCTCAAATGTCTGTCCGTCATGGGACTGTCT
ACCATCCCCCACATTCGTTTTCGCCTATTCGAGTGTGTAATATTTATGGGTGTGGCGTGGTTCTGACCTCGCAGAAGGAT
GGCGATGGACCAGTGTGTCAGAGCCATCGCATGGACATGGAGAGTATCCGTCGAGTCAACCAGACGTCAGGGAACAGAGG
TATTCCTTCTTCGATTGCGTTTGGTTTGGCACTTCGTCGCGCAGCTGCGGAACCGCAACGACAGCAGAAAGGGCCTGCTC
CGGGCCTTTCCCATGAGAAACGCGCTGCGGCTGGTGACCCCCGAAGCCCTAGGCACGTACATGTGAGATCTTCCATAAAT
ATGGACAAGGGTAAACACCCGAAAGAAACGACCGACTATACTAACATGGATTTAGTGGGAGCCGTCGGAAAAGCCGTTTC
TAATGTTGTGTCAACGATGCGAGCTGAAGGCTTCAACCTCGAATTTACATATCCTCTAACAGAAGCGGAAACTGCATTAT
ATCGGAGGGAATCCAGGATCGCCAAAACGTCGGGACCTCCATCAAATTACCCTCCGATACCTTACTCGCCAAAAACTTTG
GCACCGCCGCCATCGTCACAACTACCTCCCCTTCCAATTTCCACTGTACATCTCACCTCAAACGGGGCAGGTACGAAAGA
ACGATTAGAGATTGTCGATCTCACAATTGGTGAGGACGACAAGCCTTCAACATCAAAGACAGGCAGAGGTTCGCAATTGC
CTAAGTCTGGTGTTCCTACTACTGCCAGCAGAACGAATGACTTCAGCCCATATCCAGCGGACCACCTTCCCCGTCAAGGC
GATTATACCTATCCCCGCCCTGTTGTTCCAGGCCAAGCTCAAGCTTTTCATCCTCAGCTACCATCGCAAACTCCAAGGCA
TTTAGCTCCTCGAATGCGAACCTGTACCACTCCCGGCTGTACAGGTCTCATCAAGCCCGATAGCGCTGCAAAGCGTTGCT
ATGGATGTGTTATGTCGAACTGGAAAGCTCGCAGGCCTGTGTTTATTTCAACGCAGGCAGATGTGGGAGCGAATACCAGT
TCGGATAAAGCGGGCAGTGAACCCCCTGGTGTCGTAGATCAGCAACGAGATAATAGTGGCCCATCAACTAAGAAACGAAA
GAGCGTTACATGGGCTGACGGATGGAATCCCGGTGAAGATGTAGTAGAGAATGTAGAGATGACCACAGTCCAAGAACCGC
AAGCCTCTGAGCAGGCAGCAGAGGCGGAAGANGAAGACGCCATTTCGGGATGGGATAGCGATTTGACGGACCTGGAAGGC
TCGACCACGAGTGAAGAAAGCAACTCACAGGACGGCGAAAGTAGTGATTCGGATACTTCAAGTGCTTCCGAGACACCACT
TGCGTGTAAACCAATACGAACTGGATTTAAAATCCGTATACCTCCCAGACCTAGACCACAATCGCAACATGCGCCGTCAC
CATTACCTCGAGTCCGGCTAATACTTTCCAGACCGCCTACTTCATCCTCTATCCCGATACTTNNCAGACCTGGTATGGCA
GCCTCTCTATCCTCCTCCTCCGCTCCCTTTCCGGCGTCCACACCCTCTGTTTCTGGAGAAGCAAAACCTTCGGCTCAAGA
TGCGCCTGATCCTCGCTGCGTCACTAAAGCGTGCGGTGCACCTTTACCCTCTGGGTACGCCTGGAAATGTTGTCCAGAAT
GCCGTGCTCGTACTCGGAAATATCAACTTGGGTACCAGGAGCAATATGTTGAAGCCCAGAACGGTCGTCAAAAGGACGTA
AGCATTCCCCATCCAGTGACCGCTGCTAGCTCCCCAAAGACCGTTAAGCAGATTGACAGTACCTCCATTGCGAAAGCAGG
CCTGCCCATCAAGCTTCCTCTCAGGGTTTGCAGTGTCAGTGGGTCTGACGCTACTTTGGTAGACCCTCGAGGCCTTCTGG
TGTCCCAAGCGAGGCTCTGCATAATCAAGAACTGCAAACATATTCTTCCGGCGGTGGCTGAGTATCAGTGGGATATGTGT
CATCCTTGTCGGGAAAGGACCACCAGGACCAGACAAATCAAGCAAATAAAGGCCACTCAAGGAACAAATGCAGAGGAAAT
GATTCGAGGACTTAATGCAACGCCTCCGCAGCCTACGCCACAATGTCCAGGCCGCTTTGCAAGGTGTATATACATCGATT
GTGGCATCCGATTGGATCCTCATCGCTGCAATCAGGAATGTGGACAGTGCCGTTGGAGGAAGCTTCCCCCGGAAAGGAGA
AAAACCGCGACGCTTCCTTTACATGATCATGTATTCGTCCTCACGACAGAGGTCACGAAACATACTACTACCGCTGAAGT
AGCATTCAATGAAACGTTCAAATCTTCCACACCCGAAACGGTAGATTCATTTCATGGTACCACTCCAACCCATCCGGTCC
CTATTCCACCTGACAAGCCACGTCCACCGACCCTATACCCAGAATATACCTCCCTCTCTCGTCTGCTTGCCAATTTTNNN
NNNNNNNNNNNNNNNNNNNNNNNNNNNNNNNNNNNNNNNNNNNNNNNTAAGGGCTCTAGAAATCCTGCTAAATTTGGGTT
CGATGGCGAGTACTCTATTGTCGCGGCTAATCTTGATGTAAAGGGCAGGGAGCAAGAGGTAGTGATGTCAGTCACAAATG
TAATGCAAGAGATTGAGAGGGTGGGGCAGCTGCGATTTGAATGCGTGTTGTCCAGTCCTCAAAGCCGAGTCTCCTCATTT
GCGTTCGGCGGAATTATTACCCGTTTCAACTGCCAACAAAACATTACATTAGCAATACAACCACAGACTCAGCCACCACC
TATAAGGACTATGATAGGAGAATTGGAAATAGTTGTGTTACCTGATGACTCGCATCGCTTTATACCCGGTCAAAGAACTG
TGGTGCGTTTTAGATTAGTTGGA

Mp4071
ATGTCTCAGTTAGGCCCTGGGGTGGCTGATGCGCAGGCGTCTGCTAATCTCCAGCAGGGGACCACGTCTCTGGCTGCTAT
CACGCTTGCTTCAAACGCTGGGAAGCGTCCACCATGGAAGAGACGAAAACTGGACCCTAAGATGATCGAATCTTTGGCAT
TGCTAGGCTCGGACTCTTCGACGCAAGAAGCAGCCGTGGTGGAACCTGTAAATCAACAGATGGGCAAGGAGAACATGGTT
ATACAACCTTGTATCTCACCTCCGGTGGACAAAGACGTTTCTGATTCGGATATTCAACCGAATCGCCGACCGGCCGCTGA
CCCACATACCGGTACTTCACCACNGCNNCCAATACAGAATCTGCCTCATCCTCAAATGTCTGTCCGTCATGGGACTGTCT
ACCATCCTCCACATTCGTTTTTTCCTATTCGAGTGTGTAATATTTATGGGTGTGGCGTGGTTCTGACCTCGCAGAAGGAT
GGCGATGGACTAGTGTGTCAGAGTCATCGCATGGACATGGAGAGTATCCGTCGAGTCAACCAAACGTCAGGGAACAGAGG
TATTCCTTCTTCGATTGCGTTTGGTTTGGCACTGCGTCGCGCAGCTGCGGAACCGCAACGACAGCAGAAAGGGCCTGCTC
CGGGCCCTTCCCATGGGAAAAGCGTTGTGGCTGCTGACTCTCGAAGTTCTAGGCACGTACATGGGAGATCTTCCATAAAT
ATGGACAAGAGTAAACACCCGAAAGAAACGACCGACTATACTAACATGGATTTAGTGGGAGCCGTCGGAAAAGCCGTTTC
TAATGTTGTGTCAACGATGCGAGCTGAAGGCTTCAACCTCGAATTTACATATCCTCTAACAGAAGCGGAAACTGCATTAT
CCCGGAGGGAATCCAAGATCGCCAAAACGTCGAGACCTCCATCAAATTACCCTCCGATACCTTACTCGCCAAAAACTTTG
GCACCGCCGCCATCGTCACAACTACCTTCCCTTCCAATTTCTACTGTACATCTCACCTCAAACGGGGCAGGTACGAAAGA
ACGATTAGAGATTGTCGATCTCACAATTGGTGAGGACGACAAGCCTTCAACATCAAAGACAGGCAGAGGTTCGCAATTGC
CTAAGTCTGGTGTTCCTACTACTGCTAGCAGAACGAATGACTTCAGCCCATATCCAGCGGACCACCTTCCCCGTCAAGGC
GATTATACCTATCCCCGACCTGTTGTTCCAAGCCAAGCTCAAGCTTTTCATCCTCAGCTACCATCGCAAACCCCAAGACA
TTTAGGTCCTCGAATGCGAACCTGTACCACTCCCGGCTGTACAGGTCTCATCAAGCCCGATAGCACTGCAAAGCGTTGCT
ATGGATGTGTTATGTCGAACTGGAAAGCTCGCAGGCCTGTGTTTATTTCAACACAGGCAGATGTGAGAGCGAATACCAGT
TCGGATAAAGCAGGCAGTGAACCCCCTGGTGTCGTAGATCAGCAACGAGATAATAGTGGCCCATCAACTAAGAAACGAAA
GAGCGTTACATGGGCTGACGGATGGAATCCCGGTGAAGATGTAGTAGAGGATGTAGAGATGACCACAGTCCAAGAACCGC
AAGCCTCTGAGCAGGCAGCAGAGGCGGAAGAAGAAGACGCCATTTCGGGATGGGATAGCGATTTGACGGACCTGGAAGGT
TCCACCACGAGTGAAGAAAGCAACTCACAGGACGGCGAAAGTAGTGATTCGGATACTTCAGGTGCTTCCGACACACCACT
TGCGTGTAAACCAATACGAACTGGATTCAAAATCCGTATACCTCCCAGACCTAGACCACAATCGCAACATGCGCCGTCAC
CATTACCTCGAGTCCGGCTGATACTTTCCAGACCGCCTACTTCATCCTCTATCCCGATACTTNNCAGAACTGGTATGNCA
GCCTCTCTATCCTCCTCCNNNGCTCCCTTTCCAGCGTCCACACCCTCTGTTTCTGGAGAAGCAAAACCTNNNNNNNNNGA
TGCGCCTGATCCTCGCTGCGTCACTAAAGCGTGCAGTGCACCTTTACCCTCTGGGTACGCCTGGAAATGTTGTCCAGAAT
GCCGTGCTCGTACTCGGAAGGATCAACTTGGGTACCAGGAGCAATATGTTGAAGCCCAGAACGGTCGTCAAAAGGACGTA
AGCATTCCCCATCCAGTGACCGCTGCTAGCTCCCCAAAGACCGTTAAGCAGATTGACAGTACCTCCGTTGCGAAAGCAGG
CCTGCCCATCAAGCTTCCTCTCAGGNNNTGCAGTGTCAGTGGGTCTGACGCTACTTTGGTAGACCCTCGAGGCCTTCTGG
TGCCCCAAGCAAGGCTCTGCATAATCAAGAACTGCAAACATATTCTTCCGGCGGTGGCTGAGTATCAGTGGGATATGTGT
CATCCTTGTCGGGAAAGGACCACCAGGAACAGACAAATCAGGCAAATAAAGGCCACTCAAGGAACAAATGCAGAGGAAAC
AATTCGAGGACTTAATGCAACGCCTCCGCAACCTACGCCACAATGTCCAGGCCGCTTTGCAAGGTGTATATACATCGATT
GTGGCATCCGATTGGATCCTCATCGCTGCAATCAGGAATGTGGACAGTGCCGTTGGAGGAAGCTTCCCCCGGAAAGGAGA
AAAACCGCAACGCTTCCTTTACATGATCATGTATTCGTCCTCACGGCAGAGGTCACGAAACATACTACTACCGCTGAAGT
AGCATTCAATGAAACGTTCAAATCTTCCACACCCGAAACGGTAGATTCATTTCATGGTACCACACCAACCCATCCGGTCC
CTATTCCACCTGACAAGCCACGTCCACCGACCCTATACCCAGAATATACCTCCCTCTCTCGTCTGCTTGCCAATTTTNNN
NNNNNNNNNNNNNNNNNNNNNNNNNNNNNNNNNNNNNNNNNNNNNNNTAAGGGCTCTAGAAACCCTGCTAAATTTGGGTT
CAATGGCGAGTACTCTATTGTCGCGGCTAATCTCGATGTAAAGGGCAGGGAGCAAGAGGTAGTGATGTCAGTCACAAACG
TAATGCAAGAGATTGAGAGGGTGGGGCAGCTGCGATTTGAATGCGTGTTGTCCAGCCCTCAAAGCCGAGTCTCCTCATTT
GCGTTCGGCGGAATTATTACCCGTTTCAACTGCCAACAAAACATTACATTAGCAATACAACCACAGACTCAGCCACCACC
TATAAGGACTATGATAGGAGAATTGGAAATAGTTGTGTTACCTGATGACTCGCATCGCTTTATACCCGGTCAAAGAACTG
TGGTGCGTTTTAGGTTAGTTGGA

Mp4124
ATGTCTCAGTTAGGCCCTGGGGTGGCTGATGCGCAGGCGTCTGCTAATCTCCAGCAGGGGACCACGTCTCTGGCTGCTAT
CACGCTTGCTTCAAACGCTGGGAAGCGTCCACCATGGAAGAGACGAAAACTGGACCCTAAGATGATCGAATCTTTGGCAT
TGCTAGGCTCGGACTCTTCGACGCAAGAAGCAGCCGTGGTGGAACCTGTAAATCAACAGATGGGCAAGGAGAACATGGTT
ATACAACCTTGTATCTCACCTCCGGTGGACAAAGACGTTTCTGATTCGGATATTCAACCGAATCGCCGACCGGCCGCTGA
CCCACATACCGGTACTTCACCACAGCAACCAATACAGAATCTGCCTCATCCTCAAATGTCTGTCCGTCATGGGACTGTCT
ACCATCCTCCACATTCGTTTTTTCCTATTCGAGTGTGTAATATTTATGGGTGTGGCGTGGTTCTGACCTCGCAGAAGGAT
GGCGATGGACTAGTGTGTCAGAGTCATCGCATGGACATGGAGAGTATCCGTCGAGTCAACCAAACGTCAGGGAACAGAGG
TATTCCTTCTTCGATTGCGTTTGGTTTGGCACTGCGTCGCGCAGCTGCGGAACCGCAACGACAGCAGAAAGGGCCTGCTC
CGGGCCCTTCCCATGGGAAAAGCGTTGTGGCTGCTGACTCTCGAAGTTCTAGGCACGTACATGGGAGATCTTCCATAAAT
ATGGACAAGAGTAAACACCCGAAAGAAACGACCGACTATACTAACATGGATTTAGTGGGAGCCGTCGGAAAAGCCGTTTC
TAATGTTGTGTCAACGATGCGAGCTGAAGGCTTCAACCTCGAATTTACATATCCTCTAACAGAAGCGGAAACTGCATTAT
CCCGGAGGGAATCCAAGATCGCCAAAACGTCGAGACCTCCATCAAATTACCCTCCGATACCTTACTCGCCAAAAACTTTG
GCACCGCCGCCATCGTCACAACTACCTTCCCTTCCAATTTCTACTGTACATCTCACCTCAAACGGGGCAGGTACGAAAGA
ACGATTAGAGATTGTCGATCTCACAATTGGTGAGGACGACAAGCCTTCAACATCAAAGACAGGCAGAGGTTCGCAATTGC
CTAAGTCTGGTGTTCCTACTACTGCTAGCAGAACGAATGACTTCAGCCCATATCCAGCGGACCACCTTCCCCGTCAAGGC
GATTATACCTATCCCCGACCTGTTGTTCCAAGCCAAGCTCAAGCTTTTCATCCTCAGCTACCATCGCAAACCCCAAGACA
TTTAGGTCCTCGAATGCGAACCTGTACCACTCCCGGCTGTACAGGTCTCATCAAGCCCGATAGCACTGCAAAGCGTTGCT
ATGGATGTGTTATGTCGAACTGGAAAGCTCGCAGGCCTGTGTTTATTTCAACACAGGCAGATGTGAGAGCGAATACCAGT
TCGGATAAAGCAGGCAGTGAACCCCCTGGTGTCGTAGATCAGCAACGAGATAATAGTGGCCCATCAACTAAGAAACGAAA
GAGCGTTACATGGGCTGACGGTTGGAATCCCGGTGAAGATGTAGTAGAGGATGTAGAGATGACCACAGTCCAAGAACCGC
AAGCCTCTGAGCAGGCAGCAGAGGCGGAAGAAGAAGACGCCATTTCGGGATGGGATAGCGATTTGACGGACCTGGAAGGT
TCCACCACGAGTGAAGAAAGCAACTCACAGGACGGCGAAAGTAGTGATTCGGATACTTCAGGTGCTTCCGACACACCACT
TGCGTGTAAACCAATACGAACTGGATTCAAAATCCGTATACCTCCCAGACCTAGACCACAATCGCAACATGCGCCGTCAC
CATTACCTCGAGTCCGGCTGATACTTTCCAGACCGCCTACTTCATCCTCTATCCCGATACTTNNCAGACCTGGTATGGCA
GCCTCTCTATCCTCCTCCNNNGCTCCCTTTCCAGCGTCCACACCCTCTGTTTCTGGAGAAGCAAAACCTNNNNNNNNNGA
TGCGCCTGATCCTCGCTGCGTCACTAAAGCGTGCAGTGCACCTTTACCCTCTGGGTACGCCTGGAAATGTTGTCCAGAAT
GCCGTGCTCGTACTCGGAAGGATCAACTTGGGTACCAGGAGCAATATGTTGAAGCCCAGAACGGTCGTCAAAAGGACGTA
AGCATTCCCCATCCAGTGACCGCTGCTAGCTCCCCAAAGACCGTTAAGCAGATTGACAGTACCTCCGTTGCGAAAGCAGG
CCTGCCCATCAAGCTTCCTCTCAGGNNNTGCAGTGTCAGTGGGTCTGACGCTACTTTGGTAGACCCTCGAGGCCTTCTGG
TGCCCCAAGCAAGGCTCTGCATAATCAAGAACTGCAAACATATTCTTCCGGCGGTGGCTGAGTATCAGTGGGATATGTGT
CATCCTTGTCGGGAAAGGACCACCAGGAACAGACAAATCAGGCAAATAAAGGCCACTCAAGGAACAAATGCAGAGGAAAC
AATTCGAGGACTTAATGCAACGCCTCCGCAACCTACGCCACAATGTCCAGGCCGCTTTGCAAGGTGTATATACATCGATT
GTGGCATCCGATTGGATCCTCATCGCTGCAATCAGGAATGTGGACAGTGCCGTTGGAGGAAGCTTCCCCCGGAAAGGAGA
AAAACCGCAACGCTTCCTTTACATGATCATGTATTCGTCCTCACGGCAGAGGTCACGAAACATACTACTACCGCTGAAGT
AGCATTCAATGAAACGTTCAAATCTTCCACACCCGAAACGGTAGATTCATTTCATGGTACCACACCAACCCATCCGGTCC
CTATTCCACCTGACAAGCCACGTCCACCGACCCTATACCCAGAATATACCTCCCTCTCTCGTCTGCTTGCCAATTTTNNN
NNNNNNNNNNNNNNNNNNNNNNNNNNNNNNNNNNNNNNNNNNNNNNNTAAGGGCTCTAGAAACCCTGCTAAATTTGGGTT
CAATGGCGAGTACTCTATTGTCGCGGCTAATCTCGATGTAAAGGGCAGGGAGCAAGAGGTAGTGATGTCAGTCACAAACG
TAATGCAAGAGATTGAGAGGGTGGGGCAGCTGCGATTTGAATGCGTGTTGTCCAGCCCTCAAAGCCGAGTCTCCTCATTT
GCGTTCGGCGGAATTATTACCCGTTTCAACTGCCAACAAAACATTACATTAGCAATACAACCACAGACTCAGCCACCACC
TATAAGGACTATGATAGGAGAATTGGAAATAGTTGTGTTACCTGATGACTCGCATCGCTTTATACCCGGTCAAAGAACTG
TGGTGCGTTTTAGGTTAGTTGGA

Mp4145
ATGTCTCAGTTAGGCCCTGGGGTGGCTGATGCGCAGGCGTCTGCTAATCTCCAGCAGGGGACCACGTCTCTAGCTGCTAT
CACGCTTGCTTCAAACGCTGGGAAGCGTCCACCATGGAAGAGACGAAAACTGGACCCTAAGATGATCGAATCTTTGGCAT
TGCTAGGCTCGGACTCTTCGACGCAAGAAGCAGCCGTGGTGGAACCTGTAAATCAACAGATGGGCAAGGAGAACATGGTT
ATACAACCTTGTATCTCACCTCCGGTGAACAGAGACGTTTCTGATTCGGATATTCAACCGAATCGCCGACCGGCCGCTGA
CCCACATACCGGTGCTTCACCACAGCAACCAATACAAAATCTGCCTCATCCTCAAATGTCTGTCCGTCATGGGACTGTCT
ACCATCCCCCACATTCGTTTTCGCCTATTCGAGTGTGTAATATTTATGGGTGTGGCGTGGTTCTGACCTCGCAGAAGGAT
GGCGATGGACCAGTGTGTCAGAGCCATCGCATGGACATGGAGAGTATCCGTCGAGTCAACCAGACGTCAGGGAACAGAGG
TATTCCTTCTTCGATTGCGTTTGGTTTGGCACTTCGTCGCGCAGCTGCGGAACCGCAACGACAGCAGAAAGGGCCTGCTC
CGGGCCCTTCCCATGAGAAACGCGCTGCGGCTGGTGACCCCCGAAGCCCTAGGCACGTACATGTGAGATCTTCCATAAAT
ATGGACAAGGGTAAACACCCGAAAGAAACGACCGACTATACTAACATGGATTTAGTGGGAGCCGTCGGAAAAGCCGTTTC
TAATGTTGTGTCAACGATGCGAGCTGAAGGCTTCAACCTCGAATTTACATATCCTCTAACAGAAGCGGAAACTGCATTAT
ATCGGAGGGAATCCAGGATCGCCAAAACGTCGGGACCTCCATCAAATTACCCTCCGATACCTTACTCGCCAAAAACTTTG
GCACCGCCGCCATCGTCACAACTACCTCCCCTTCCAATTTCCACTGTACATCTCACCTCAAACGGGGCAGGTACGAAAGA
ACGATTAGAGATTGTCGATCTCACAATTGGTGAGGACGACAAGCCTTCAACATCAAAGACAGGCAGAGGTTCGCAATTGC
CTAAGTCTGGTGTTCCTACTACTGCCAGCAGAACGAATGACTTCAGCCCATATCCAGCGGACCACCTTCCCCGTCAAGGC
GATTATACCTATCCCCGCCCTGTTGTTCCAGGCCAAGCTCAAGCTTTTCATCCTCAGCTACCATCGCAAACTCCAAGGCA
TTTAGCTCCTCGAATGCGAACCTGTACCACTCCCGGCTGTACAGGTCTCATCAAGCCCGATAGCGCTGCAAAGCGTTGCT
ATGGATGTGTTATGTCGAACTGGAAAGCTCGCAGGCCTGTGTTTATTTCAACGCAGGCAGATGTGGGAGCGAATACCAGT
TCGGATAAAGCGGGCAGTGAACCCCCTGGTGTCGTAGATCAGCAACGAGATAATAGTGGCCCATCAACTAAGAAACGAAA
GAGCGTTACATGGGCTGACGGATGGAATCCCGGTGAAGATGTAGTAGAGAATGTAGAGATGACCACAGTCCAAGAACCGC
AAGCCTCTGAGCAGGCAGCAGAGGCGGAAGAAGAAGACGCCATTGCGGGATGGGATAGCGATTTGACGGACCTGGAAGGC
TCGACCACGAGTGAAGAAAGCAACTCACAGGACGGCGAAAGTAGTGATTCGGATACTTCAAGTGCTTCCGACACACCACT
TGCGTGTAAACCAATACGAACTGGATTTAAAATCCGTATACCTCCCAGACCTAGACCACAATCGCAACATGCGCCGTCAC
CATTACCTCGAGTCCGGCTAATACTTTCCAGACCGCCTACTTCATCCTCTATCCCGATACTTNNCAGACCTGGTATGGCA
GCCTCTCTATCCTCCTCCTCCGCTCCCTTTCCGGCGTCCACACCCTCTGTTTCTGGAGAAGCAAAACCTTCGGCTCAAGA
TGCGCCTGATCCTCGCTGCGTCACTAAAGCGTGCGGTGCACCTTTACCCTCTGGGTACGCCTGGAAATGTTGTCCAGAAT
GCCGTGCTCGTACTCGGAAATATCAACTTGGGTACCAGGAGCAATATGTTGAAGCCCAGAACGGTCGTCAAAAGGACGTA
AGCATTCCCCATCCAGTGACCGCTGCTAGCTCCCCAAAGACCGTTAAGCAGATTGACAGTACCTCCATTGCGAAAGCAGG
CCTGCCCATCAAGCTTCCTCTCAGGGTTTGCAGTGTCAGTGGGTCTGACGCTACTTTGGTAGACCCTCGAGGCCTTCTGG
TGTCCCAAGCGAGGCTCTGCATAATCAAGAACTGCAAACATATTCTTCCGGCGGTGGCTGAGTATCAGTGGGATATGTGT
CATCCTTGTCGGGAAAGGACCACCAGGACCAGACAAATCAAGCAAATAAAGGCCACTCAAGGAACAAATGCAGAGGAAAT
GATTCGAGGACTTAATGCAACGCCTCCGCAGCCTACGCCACAATGTCCAGGCCGCTTTGCAAGGTGTATATACATCGATT
GTGGCATCCGATTGGATCCTCATCGCTGCAATCAGGAATGTGGACAGTGCCGTTGGAGGAAGCTTCCCCCGGAAAGGAGA
AAAACCGCGACGCTTCCTTTACATGATCATGTATTCGTCCTCACGACAGAGGTCACGAAACATACTACTACCGCTGAAGT
AGCATTCAATGAAACGTTCAAATCTTCCACACCCGAAACGGTAGATTCATTTCATGGTACCACTCCAACCCATCCGGTCC
CTATTCCACCTGACAAGCCACGTCCACCGACCCTATACCCAGAATATACCTCCCTCTCTCGTCTGCTTGCCAATTTTCCC
TACTGNNNNNNNNNNNNNNNCAGTTTCTACANNNNNAGCGCAGTCCTTAAGGGCTCTAGAAATCCTGCTAAATTTGGGTT
CGATGGCGAGTACTCTATTGTCGCGGCTAATCTCGATGTAAAGGGCAGGGAGCAAGAGGTAGTGATGTCAGTCACAAACG
TAATGCAAGAGATTGAGAGGGTGGGGCAGCTGCGATTTGAATGCGTGTTGTCCAGTCCTCAAAGCCGAGTCTCCTCATTT
GCGTTCGGCGGAATTATTACCCGTTTCAACTGCCAACAAAACATTACATTAGCAATACAACCACAGACTCAGCCACCACC
TATAAGGACTATGATAGGAGAATTGGAAATAGTTGTGTTACCTGATGACTCGCATCGCTTTATACCCGGTCAAAAAACTG
TGGTGCGTTTTAGATTAGTTGGA

MrPeru
ATGTCTCAGTTAGGCCCTGGGGTGGCTGATGCGCAGGCGTCTGCTAATCTCCAGCAGGGGACCACGTCTCTAGCTGCTAT
CACGCTTGCTTCAAACGCTGGGAAGCGTCCACCATGGAAGAGACGAAAACTGGACCCTAAGATGATCGAATCTTTGGCAT
TGCTAGGCTCGGACTCTTCGACGCAAGAAGCAGCCGTGGTGGAACCTGTAAATCAACAGATGGGCAAGGAGAACATGGTT
ATACAACCTTGTATCTCACCTCCGGTGAACAGAGACGTTTCTGATTCGGATATTCAACCGAATCGCCGACCGGCCGCTGA
CCCACATACCGGTGCTTCACCACAGCAACCAATACAAAATCTGCCTCATCCTCAAATGTCTGTCCGTCATGGGACTGTCT
ACCATCCCCCACATTCGTTTTCGCCTATTCGAGTGTGTAATATTTATGGGTGTGGCGTGGTTCTGACCTCGCAGAAGGAT
GGCGATGGACCAGTGTGTCAGAGCCATCGCATGGACATGGAGAGTATCCGTCGAGTCAACCAGACGTCAGGGAACAGAGG
TATTCCTTCTTCGATTGCGTTTGGTTTGGCACTTCGTCGCGCAGCTGCGGAACCGCAACGACAGCAGAAAGGGCCTGCTC
CGGGCCCTTCCCATGAGAAACGCGCTGCGGCTGGTGACCCCCGAAGCCCTAGGCACGTACATGTGAGATCTTCCATAAAT
ATGGACAAGGGTAAACACCCGAAAGAAACGACCGACTATACTAACATGGATTTAGTGGGAGCCGTCGGAAAAGCCGTTTC
TAATGTTGTGTCAACGATGCGAGCTGAAGGCTTCAACCTCGAATTTACATATCCTCTAACAGAAGCGGAAACTGCATTAT
ATCGGAGGGAATCCAGGATCGCCAAAACGTCGGGACCTCCATCAAATTACCCTCCGATACCTTACTCGCCAAAAACTTTG
GCACCGCCGCCATCGTCACAACTACCTCCCCTTCCAATTTCCACTGTACATCTCACCTCAAACGGGGCAGGTACGAAAGA
ACGATTAGAGATTGTCGATCTCACAATTGGTGAGGACGACAAGCCTTCAACATCAAAGACAGGCAGAGGTTCGCAATTGC
CTAAGTCTGGTGTTCCTACTACTGCCAGCAGAACGAATGACTTCAGCCCATATCCAGCGGACCACCTTCCCCGTCAAGGC
GATTATACCTATCCCCGCCCTGTTGTTCCAGGCCAAGCTCAAGCTTTTCATCCTCAGCTACCATCGCAAACTCCAAGGCA
TTTAGCTCCTCGAATGCGAACCTGTACCACTCCCGGCTGTACAGGTCTCATCAAGCCCGATAGCGCTGCAAAGCGTTGCT
ATGGATGTGTTATGTCGAACTGGAAAGCTCGCAGGCCTGTGTTTATTTCAACGCAGGCAGATGTGGGAGCGAATACCAGT
TCGGATAAAGCGGGCAGTGAACCCCCTGGTGTCGTAGATCAGCAACGAGATAATAGTGGCCCATCAACTAAGAAACGAAA
GAGCGTTACATGGGCTGACGGATGGAATCCCGGTGAAGATGTAGTAGAGAATGTAGAGATGACCACAGTCCAAGAACCGC
AAGCCTCTGAGCAGGCAGCAGAGGCGGAAGANNNNNNCGCCATTTCGGGATGGGATAGCGATTTGACGGACCTGGAAGGC
TCGACCACGAGTGAAGAAAGCAACTCACAGGACGGCGAAAGTAGTGATTCGGATACTTCAAGTGCTTCCGACACACCACT
TGCGTGTAAACCAATACGAACTGGATTTAAAATCCGTATACCTCCCAGACCTAGACCACAATCGCAACATGCGCCGTCAC
CATTACCTCGAGTCCGGCTAATACTTTCCAGACCGCCTACTTCATCCTCTATCCCGATACTTNNCAGACCTGGTATGGCA
GCCTCTCTATCCTCCTCCTCCGCTCCCTTTCCGGCGTCCACACCCTCTGTTTCTGGAGAAGCAAAACCTTCGGCTCAAGA
TGCGCCTGATCCTCGCTGCGTCACTAAAGCGTGCGGTGCACCTTTACCCTCTGGGTACGCCTGGAAATGTTGTCCAGAAT
GCCGTGCTCGTACTCGGAAATATCAACTTGGGTACCAGGAGCAATATGTTGAAGCCCAGAACGGTCGTCAAAAGGACGTA
AGCATTCCCCATCCAGTGACCGCTGCTAGCTCCCCAAAGACCGTTAAGCAGATTGACAGTACCTCCATTGCGAAAGCAGG
CCTGCCCATCAAGCTTCCTCTCAGGGTTTGCAGTGTCAGTGGGTCTGACGCTACTTTGGTAGACCCTCGAGGCCTTCTGG
TGTCCCAAGCGAGGCTCTGCATAATCAAGAACTGCAAACATATTCTTCCGGCGGTGGCTGAGTATCAGTGGGATATGTGT
CATCCTTGTCGGGAAAGGACCACCAGGACCAGACAAATCAAGCAAATAAAGGCCACTCAAGGAACAAATGCAGAGGAAAT
GATTCGAGGACTTAATGCAACGCCTCCGCAGCCTACGCCACAATGTCCAGGCCGCTTTGCAAGGTGTATATACATCGATT
GTGGCATCCGATTGGATCCTCATCGCTGCAATCAGGAATGTGGACAGTGCCGTTGGAGGAAGCTTCCCCCGGAAAGGAGA
AAAACCGCGACGCTTCCTTTACATGATCATGTATTCGTCCTCACGACAGAGGTCACGAAACATACTACTACCGCTGAAGT
AGCATTCAATGAAACGTTCAAATCTTCCACACCCGAAACGGTAGATTCATTTCATGGTACCACTCCAACCCATCCGGTCC
CTATTCCACCTGACAAGCCACGTCCACCGACCCTATACCCAGAATATACCTCCCTCTCTCGTCTGCTTGCCAATTTTCCC
TACTGNNNNNNNNNNNNAGTCAGTTTCTACANNNNNAGCGCAGTCCTTAAGGGCTCTAGAAATCCTGCTAAATTTGGGTT
CGATGGCGAGTACTCTATTGTCGCGGCTAATCTTGATGTAAAGGGCAGGGAGCAAGAGGTAGTGATGTCAGTCACAAATG
TAATGCAAGAGATTGAGAGGGTGGGGCAGCTGCGATTTGAATGCGTGTTGTCCAGTCCTCAAAGCCGAGTCTCCTCATTT
GCGTTCGGCGGAATTATTACCCGTTTCAACTGCCAACAAAACATTACATTAGCAATACAACCACAGACTCAGCCACCACC
TATAAGGACTATGATAGGAGAATTGGAAATAGTTGTGTTACCTGATGACTCGCATCGCTTTATACCCGGTCAAAGAACTG
TGGTGCGTTTTAGATTAGTTGGA
