 6 1410
Mp1441
ATGGTGCAGCACGCGCCGTCTCAAGCTGGCCTTGACTGGGCATACTCTGAAGACATTCCGGGCTCAAGATGTGGTCCTGA
CGACGGTCCATGGCCCCGACCTTACCAGATCTTGGAGGAGGAGGATATTTGGCGCGAATTGAGGTTCCTAGCAAAACCTC
AGACCTTTCATTTCGATACTTCGCGGGGCTGGAGAGCCGACAGTATCAATTTTCAACCATCGCCATCAACGAGAACCCAG
GATCGCTATGTAGTCAAGCAGTTGGAGATTAATGGAAGGCAGTGGTCTTTGACCGGTGTTTTTGATGGTCATCTTGGAGA
TGTCACTGTTGAACACGTATCACATCATTTACCCATAATTATCCAAGAATTCCTCCAGAATGCCTTTGAGAACGAGCCGT
CGCGTCTCAGTGATCCAGCGTTCATTTCGCAGTCCTTCTCGCGTTCAATTACTGCTTTCGACAAGGCTATTGCTGGAGAC
GTCTTGAACCTTTTTGGCGGTATCGAAGGCTTGTCCAATTACACTGATGCCCAAATCAGACAGGTCATCAATGACCAGCA
TAGAGGTGGCCACAACTATACTAAAGCCCGTCTCAATATGTACGNNNNNNNNNNNNNNNNNNNNNNNNNNNNNNNNNNNN
NNNNNNNNNNNNNNNNNNNNNNNNNNNNNNNNNNNNNNNNNNNNNNNGTATCCCCGNTGNAAGNNGATGACTGGNAGAGC
AACGTGCTTACGACAGACCANNATGGTGANAACGATGCNGAAGTCNAACGTGTTCTNCGGCAACATCCCGATGAACCTGA
GTGTGTACTTGACCGTCGAGTCTTAGGCGCTTTGGCCCCGTTCCGTGCCCTTGGAGACACTCCGTTCAAGCAACCTCCTG
AATTCACTCGTCGTATTCTCTTCAANNACCTTCTTCCGTTCCACGACACTTCACCCTGGGAAGAGTTCCTCGCCCGCAAC
CGTACCCCTCCATATATCTCATCCGAACCTGAGATCACGCATTACGCTCTGTCCCAACGCAAACACTCCAGACCTGGTCC
CAGGTTCCTTATCCTGTCTTCAGATGGTTTTTCCGACTTGTGCAGCAGTGAAGGGCAGCACAAGATTGTCAGGGATTGGG
CCAGGCATGTCGTACAGGAGAGCAAGAACGATAACCCCTTGACAGGGTTGCGCAATTCCATGTCGGCGGCGACTACTCCG
GAATCAAATATCAACAACATTCTACCGACCTACCCGCTGTCCCCTACGTTACCCACTGCCCCTGGTGCAGGGCAAGAGTC
GAGGAATATGGCATTGAGGTTATTGAGACGAGCACTGGGAGGCGAGGATAGGCTGAGCGTATCAAAGGTTCTGACATTGG
ATATGGACGCCGCTTGGATCGATGACACCGCGATTGTAGTGCAGACGTTA

Mp178
ATGGTGCAGCACGCGCCGTCTCAAGCTGGCCTTGACTGGGCATACTCTGAAGACATTCCGGGTTCAAGATGTGGTCCTGA
CGACGGCCCATGGCCCCGACCTTACCAGATCTTGGAGGAGGAGGATATTTGGCGCGAATTGAGGTTCCTAGCAAAACCTC
AGACCTTTCATTTCGATACTTCGCGGGGCTGGAGAGCCGACAGTATCAATTTTCAACCATCGCCGTCAACGAGAACCCAG
GATCGCTATGTAGTCAAGCAGTTGGAGATTAATGGAAGGCAGTGGTCTTTGACCGGTGTTTTTGATGGTCATCTTGGAGA
TGTCACTGTTGAACACGTATCACATCATTTACCCATAATTATCCAAGAATTCCTCCAGAATGCCTTTGAGAACGAACCGT
CGCGTCTTAGTGATCCAGCGTTCATTTCGCAGTCCTTCTCGCGTTCAATTACTGCTTTCGACAAAGCTATTGCTGGAGAC
GTCTTGAACCTTTTTGGCGGTATCGAAGGCTTGTCTAATTACACTGATGCCCAAATCAGACAGGTCATCAATGACCAGCA
TAGAGGTGGCCACAACTATACTAAAGCCCGTCTCAATATGTACGNNNNNNNNNNNNNNNNNNNNNNNNNNNNNNNNNNNN
NNNNNNNNNNNNNNNNNNNNNNNNNNNNNNNNNNNNNNNNNNNNNNNGTATNCCCGATGGAAGNANATGACTGGGAGATC
AACGTGCTTACGACAGACCACAATGGTGACAACGATGCCGAAGTCGAACGTGTTCGACGGCAGCATCCCGATGAACCTGA
GTGTGTACTTGACCGTCGAGTCTTAGGCGCTTTGGCCCCGTTCCGTGCCCTTGGAGACACTCCGTTCAAGCAACCTCCTG
AATTCACTCGTCGTATTCTCTTCAACCTTCTTCCGGGATTCCACGACACTTCACCCTGGGAAGAGTTCCTCGCCCGCAAC
CGTACCCCTCCATATATCTCATCCGAACCTGAGATCACGCATTACGCTCTGTCCCAACGCAAACACTCCAGACCTGGTCC
CAGGTTCCTTATCCTGTCTTCAGATGGTTTTTCCGATTTGTGCAGCAGTGAAGGGCAGCACAAGATTGTCAGGGATTGGG
CCAGGCATGTTGTACAGGAGAGCAAGAACGATAACCCCTTGACAGGGTTGCGCAATTCCATGTCGGCGGCGACTACTCCG
GAATCAAATATCAACAACATTCTACCGACGTACCCGCTGTCCCCTACGTTACCCACTGCCCCTGGTGCAGGGCAAGAGTC
GAGGAATATGGCATTGAGGCTATTGAGAAGAGCACTGGGAGGCGAGGATAGACTGAGCGTGTCAAAGGTTCTGACATTGG
ATATGGACGCCGCTTGGATCGATGACACCGCGATTGTAGTGCAGACGTTA

Mp4071
ATGGTNNNNNNNNNNNNNNNNNNNNNNNNNNNTGACTGGGCATACTCTGAAGACATTCCGGGCTCAAGATGTGGTCCTGA
CGACGGTCCATGGCCCCGACCTTACCAGATCTTGGAGGAGGAGGATATTTGGCGCGAATTGAGGTTCCTAGCAAAACCTC
AGACCTTTCATTTCGATACTTCGCGGGGCTGGAGAGCCGACAGTATCAATTTTCAACCATCGCCATCAACGAGAACCCAG
GATCGCTATGTAGTCAAGCAGTTGGAGATTAATGGAAGGCAGTGGTCTTTGACCGGTGTTTTTGATGGTCATCTTGGAGA
TGTCACTGTTGAACACGTATCACATCATTTACCCATAATTATCCAAGAATTCCTCCAGAATGCCTTTGAGAACGAGCCGT
CGCGTCTCAGTGATCCAGCGTTCATTTCGCAGTCCTTCTCGCGTTCAATTACTGCTTTCGACAAGGCTATTGCTGGAGAC
GTCTTGAACCTTTTTGGCGGTATCGAAGGCTTGTCCAATTACACTGATGCCCAAATCAGACAGGTCATCAATGACCAGCA
TAGAGGTGGCCACAACTATACTAAAGCCCGTCTCAATATGTACGNNNNNNNNNNNNNNNNNNNNNNNNNNNNNNNNNNNN
NNNNNNNNNNNNNNNNNNNNNNNNNNNNNNNNNNNNNNNNNNNNNNTGTATCCCCGATGGAAGGAGATGACTGGGAGATC
AACGTGCTTACGACAGACCACAATGGTGACAACGATGCCGAAGTCGAACGTGTTCGACGGCAACATCCCGATGAACCTGA
GTGTGTACTTGACCGTCGAGTCTTAGGCGCTTTGGCCCCGTTCCGTGCCCTTGGAGACACTCCGTTCAAGCAACCTCCTG
AATTCACTCGTCGTATTCTCTTCAACCTTCTTCCGGGATTCCACGACACTTCACCCTGGGAAGAGTTCCTCGCCCGCAAC
CGTACCCCTCCATATATCTCATCCGAACCTGAGATCACGCATTACGCTCTGTCCCAACGCAAACACTCCAGACCTGGTCC
CAGGTTCCTTATCCTGTCTTCAGATGGTTTTTCCGATTTGTGCAGCAGTGAAGGGCAGCACAAGATTGTCAGGGATTGGG
CCAGGCATGTTGTACAGGAGAGCAAGAACGATAACCCCTTGACAGGGTTGCGCAATTCCATGTCGGCGGCGACTACTCCG
GAATCAAATATCAACAACATTCNNNNNNNNNNNNNNNNNNNNNNNNNNNNNNNNNNNNNCCCTGGTNCAGNGCAAGATTC
GAGGAATATGGCATTGAGGCTATTGAGAAGAGCACTGGGAGGCGAGGATAGACTGAGCGTGTCAACGGTTCTGACATTGG
ATATGGACGCCGCTTGGATCGATGACACCGCGATTGTAGTGCAGACGTTA

Mp4124
ATGGTGCAGCACGCGCCGTCTCAAGCTGGCCTTGACTGGGCATACTCTGAAGACATTCCGGGCTCAAGATGTGGTCCTGA
CGACGGTCCATGGCCCCGACCTTACCAGATCTTGGAGGAGGAGGATATTTGGCGCGAATTGAGGTTCCTAGCAAAACCTC
AGACCTTTCATTTCGATACTTCGCGGGGCTGGAGAGCCGACAGTATCAATTTTCAACCATCGCCATCAACGAGAACCCAG
GATCGCTATGTAGTCAAGCAGTTGGAGATTAATGGAAGGCAGTGGTCTTTGACCGGTGTTTTTGATGGTCATCTTGGAGA
TGTCACTGTTGAACACGTATCACATCATTTACCCATAATTATCCAAGAATTCCTCCAGAATGCCTTTGAGAACGAGCCGT
CGCGTCTCAGTGATCCAGCGTTCATTTCGCAGTCCTTCTCGCGTTCAATTACTGCTTTCGACAAGGCTATTGCTGGAGAC
GTCTTGAACCTTTTTGGCGGTATCGAAGGCTTGTCCAATTACACTGATGCCCAAATCAGACAGGTCATCAATGACCAGCA
TAGAGGTGGCCACAACTATACTAAAGCCCGTCTCAATATGTACGGANNNNNNNNNNNNNNNNNNNNNNNNNNNNNNNNNN
NNNNNNNNNNNNNNNNNNNNNNNNNNNNNNNNNNNNNNNNNNNNNNNGTATCCCCGATGGAAGGAGATGACTGGGAGATC
AACGTGCTTACGACAGACCACAATGGTGACAACGATGCCGAAGTCGAACGTGTTCGACGGCAACATCCCGATGAACCTGA
GTGTGTACTTGACCGTCGAGTCTTAGGCGCTTTGGCCCCGTTCCGTGCCCTTGGAGACACTCCGTTCAAGCAACCTCCTG
AATTCACTCGTCGTATTCTCTTCANNNACCTTCTTCCGTTCCACGACACTTCACCCTGGGAAGAGTTCCTCGCCCGCAAC
CGTACCCCTCCATATATCTCATCCGAACCTGAGATCACGCATTACGCTCTGTCCCAACGCAAACACTCCAGACCTGGTCC
CAGGTTCCTTATCCTGTCTTCAGATGGTTTTTCCGACTTGTGCAGCAGTGAAGGGCAGCACAAGATTGTCAGGGATTGGG
CCAGGCATGTCGTACAGGAGAGCAAGAACGATAACCCCTTGACAGGGTTGCGCAATTCCATGTCGGCGGCGACTACTCCG
GAATCAAATATCAACAACATTCTACCGACCTACCCGCTGTCCCCTACGTTACCCACTGCCCCTGGTGCAGGGCAAGAGTC
GAGGAATATGGCATTGAGGTTATTGAGACGAGCACTGGGAGGCGAGGATAGGCTGAGCGTATCAAAGGTTCTGACATTGG
ATATGGACGCCGCTTGGATCGATGACACCGCGATTGTAGTGCAGACGTTA

Mp4145
ATGGTGCAGCACGCGCCGTCTCAAGCTGGCCTTGACTGGGCATACTCTGAAGACATTCCGGGCTCAAGATGTGGTCCTGA
CGACGGTCCATGGCCCCGACCTTACCAGATCTTGGAGGAGGAGGATATTTGGCGCGAATTGAGGTTCCTAGCAAAACCTC
AGACCTTTCATTTCGATACTTCGCGGGGCTGGAGAGCCGACAGTATCAATTTTCAACCATCGCCATCAACGAGAACCCAG
GATCGCTATGTAGTCAAGCAGTTGGAGATTAATGGAAGGCAGTGGTCTTTGACCGGTGTTTTTGATGGTCATCTTGGAGA
TGTCACTGTTGAACACGTATCACATCATTTACCCATAATTATCCAAGAATTCCTCCAGAATGCCTTTGAGAACGAGCCGT
CGCGTCTCAGTGATCCAGCGTTCATTTCGCAGTCCTTCTCGCGTTCAATTACTGCTTTCGACAAGGCTATTGCTGGAGAC
GTCTTGAACCTTTTTGGCGGTATCGAAGGCTTGTCCAATTACACTGATGCCCAAATCAGACAGGTCATCAATGACCAGCA
TAGAGGTGGCCACAACTATACTAAAGCCCGTCTCAATATGTACGNNNNNNNNNNNNNNNNNNNNNNNNNNNNNNNNNNNN
NNNNNNNNNNNNNNNNNNNNNNNNNNNNNNNNNNNNNNNNNNNNCTTGTATCCCCGATGGAAGGAGATGACTGGGAGATC
AACGTGCTTACGACAGACCACAATGGTGACAACGATGCCGAAGTCGAACGTGTTCGACGGCAACATCCCGATGAACCTGA
GTGTGTACTTGACCGTCGAGTCTTAGGCGCTTTGGCCCCGTTCCGTGCCCTTGGAGACACTCCGTTCAAGCAACCTCCTG
AATTCACTCGTCGTATTCTCTTCAACTACCTTCTTCCGTTCCACGACACTTCACCCTGGGAAGAGTTCCTCGCCCGCAAC
CGTACCCCTCCATATATCTCATCCGAACCTGAGATCACGCATTACGCTCTGTCCCAACGCAAACACTCCAGACCTGGTCC
CAGGTTCCTTATCCTGTCTTCAGATGGTTTTTCCGACTTGTGCAGCAGTGAAGGGCAGCACAAGATTGTCAGGGATTGGG
CCAGGCATGTCGTACAGGAGAGCAAGAACGATAACCCCTTGACAGGGTTGCGCAATTCCATGTCGGCGGCGACTACTCCG
GAATCAAATATCAACAACATTCTACCGACCTACCCGCTGTCCCCTACGTTACCCACTGCCCCTGGTGCAGGGCAAGAGTC
GAGGAATATGGCATTGAGGTTATTGAGACGAGCACTGGGAGGCGAGGATAGGCTGAGCGTATCAAAGGTTCTGACATTGG
ATATGGACGCCGCTTGGATCGATGACACCGCGATTGTAGTGCAGACGTTA

MrPeru
ATGGTGCAGCACGCGCCGTCTCAAGCTGGCCTTGACTGGGCATACTCTGAAGACATTCCGGGTTCAAGATGTGGTCCTGA
CGACGGCCCATGGCCCCGACCTTACCAGATCTTGGAGGAGGAGGATATTTGGCGCGAATTGAGGTTCCTAGCAAAACCTC
AGACCTTTCATTTCGATACTTCGCGGGGCTGGAGAGCCGACAGTATCAATTTTCAACCATCGCCGTCAACGAGAACCCAG
GATCGCTATGTAGTCAAGCAGTTGGAGATTAATGGAAGGCAGTGGTCTTTGACCGGTGTTTTTGATGGTCATCTTGGAGA
TGTCACTGTTGAACACGTATCACATCATTTACCCATAATTATCCAAGAATTCCTCCAGAATGCCTTTGAGAACGAACCGT
CGCGTCTTAGTGATCCAGCGTTCATTTCGCAGTCCTTCTCGCGTTCAATTACTGCTTTCGACAAAGCTATTGCTGGAGAC
GTCTTGAACCTTTTTGGCGGTATCGAAGGCTTGTCTAATTACACTGATGCCCAAATCAGACAGGTCATCAATGACCAGCA
TAGAGGTGGCCACAACTATACTAAAGCCCGTCTCAATATGTACGNNNNNNNNNNNNNNNNNNNNNNNNNNNNNNNNNNNN
NNNNNNNNNNNNNNNNNNNNNNNNNNNNNNNNNNNNNNNNNNNNCTTGTATCCCCGATGGAAGGAGATGACTGGGAGATC
AACGTGCTTACGACAGACCACAATGGTGACAACGATGCCGAAGTCGAACGTGTTCGACGGCAGCATCCCGATGAACCTGA
GTGTGTACTTGACCGTCGAGTCTTAGGCGCTTTGGCCCCGTTCCGTGCCCTTGGAGACACTCCGTTCAAGCAACCTCCTG
AATTCACTCGTCGTATTCTCTTCAACCACCTTCTTCCGTTCCACGACACTTCACCCTGGGAAGAGTTCCTCGCCCGCAAC
CGTACCCCTCCATATATCTCATCCGAACCTGAGATCACGCATTACGCTCTGTCCCAACGCAAACACTCCAGACCTGGTCC
CAGGTTCCTTATCCTGTCTTCAGATGGTTTTTCCGATTTGTGCAGCAGTGAAGGGCAGCACAAGATTGTCAGGGATTGGG
CCAGGCATGTTGTACAGGAGAGCAAGAACGATAACCCCTTGACAGGGTTGCGCAATTCCATGTCGGCGGCGACTACTCCG
GAATCAAATATCAACAACATTCTACCGACGTACCCGCTGTCCCCTACGTTACCCACTGCCCCTGGTGCAGGGCAAGAGTC
GAGGAATATGGCATTGAGGCTATTGAGAAGAGCACTGGGAGGCGAGGATAGACTGAGCGTGTCAAAGGTTCTGACATTGG
ATATGGACGCCGCTTGGATCGATGACACCGCGATTGTAGTGCAGACGTTA
