 6 1515
Mp1441
ATGTCGAACCTGCGCGACGCATTGCTGAACGGCCTCAAAAATCTGCCCGGCACACGCGAGTTCCATCTCCACGTCCTCGT
CTCATCGCCCAGGAAGCATGGCGGACTGTACCCTTTCTCCTTNNNNNNNNNNNNNNNNNNNCTCCAGGACGTTCTGATTT
TGCTGTCAGAGCAAAGCACCCCAGATTCGCCCCGTATTTTTGTCGCGGCCATTGAGGCGTGCGTGTACAATGTCGCAGCA
ACATCGAGCGCGATATTGTATATCTCAAAGGTCGACTCGACAGGCCAAGCTTCCTATCCTTCCCCCACTGCCACGTTGGT
CAAGTCTTTTCTGTTCTACTACGCCGATCCTGCTACAAGACCTATCGATGTCGACCACCTCTGGATTCAGCTTTTTGCCA
GAGCCCAAAAACAATACGTCTTTCCAAATTCGTCAGAGTATGAGGGGAAGAAATGGTTGAACGATATGAAGCTTTGTAGT
TGGTGGAAAAGGATTTACACAGATGTGTCTACAGAGTTGGCGAGTCGACTGCCTTCGACTGCGCTTGTGAAGCTTTACTA
CCTCATTCCCGGATATNACACAACGANAGCTGAACAATCCTTGAAGATTGCCTCCTCATCCACCGGAAATGACAATCAGA
ATGCACCAATGTGGATATACGGACATCCGTATTCCCAGACCGACATCCCCCTGCCTTGCCCTCAGGACACTGGTTCGTCC
AGTTCCATTGTTAGGAACTTGGGCCACTATATACCTTCTTTTGATGACGATCCCAAGTCGCGTTTCATGGACGAGATTGC
ATNNNNNNNNGAGAAAGAAGGGATCAAGTCACCGCCTCGAAAACGGGCGCGCACAATATCATCTTCGCGTCATCCAGACG
CCGTTCCTGTATCAGGATCCGCAGCAGCAGAAGATGATNNNNNAGAGAAGCCGGGGAGTCAGGATCGGCCACTGGGAGAG
TTGAGTAAGGTCTCCCCAGACGAATTTTGGGAGCGTATGTCTTTCAGGCAGGAATGCGTGTCGGGAGCTGTGACAGGGTT
TTTCACAATGGGGATTAGTTTCAAAGCTGCGGATGAGGATGGTTCTCGGTCGACCGTCNCNCCTCTTGCTCCTCAAGCTG
GACAGGTATCCTCGAATGTCCACAAAAGAGTCATGACATCGCTTATGACCGGCGTTGAGTTCTCCACGAAAGAACGGGCG
ATTAACGCCACAGAATCGATCGAGAACGCTATCAAAGGACTTTGCGAAGGAATCGCACTGGTTCCCGTTCCAGCTATCCA
ACCAACTCGTCCAAAATCAACGAGCAATCAAGAANNNNNNNNNNNNNNNNGATCTCCGACCCANNGANGATCGACATATT
TAGCACCACCACGGACGCCACCGCGTCGCAACAGAGAGTTGCTACCCGATATCTCTCCCAATCCCTTTCCAGAACCGGAG
CCGACGTTGGAGACGTACAATTCTCATATCTACGGATCGGTCCTGGCCGTCCGAAAGAAGAAGAAAAGAGCCGAT

Mp178
ATGTCGAACCTGCGCGACGCATTGCTGAACGGCCTCAAAAATCTGCCCGGCACACGCGAGTTCCATCTCCACGTCCTCGT
CTCATCGCCCAGGAAGCATGGCGGACTGTACCCTTTCTCCTTNNNNACCTCGATNCTCTATCTCCAGGACGTTCTGATTT
TGCTGTCAGAGCAAAGCACCCCAGATTCGCCCCGTATTTTTGTCGCGGCCATTGAGGCGTGCGTGTACAATGTCGCAGCA
ACATCGAGCGCGATATTGTATATCTCAAAGGTCGACTCGACAGGCCAAGCTTCCTATCCTTCCCCCACTGCCACGTTGGT
CAAGTCTTTTCTGTTCTACTACGCCGATCCTGCTACAAGACCTATCGATGTCGACCACCTCTGGATTCAGCTTTTTGCCA
GAGCCCAAAAACAATACGTCTTTCCAAATTCGTCAGAGTATGAGGGGAAGAAATGGTTGAACGATATGAAGCTTTGTAGT
TGGTGGAAAAGGATTTACACAGATGTGTCTACAGAGTTGGCGAGTCGACTGCCTTCGACTGCGCTTGTGAAGCTTTACTA
CCTCATTCCCGGATATNACACAACGANAGCTGAACAATCCTTGAAGATTGCCTCCTCATCCACCGGAAATGACAATCAGA
ATGCACCAATGTGGATATACGGACATCCGTATTCCCAGACCGACATCCCCCTGCCTTGCCCTCAGGACACTGGTTCGTCC
AGTTCCATTGTTAGGAACTTGGGCCACTATATACCTTCTTTTGATGACGATCCCAAGTCGCGTTTCATGGACGAGATTGC
ATATACGACGGAGAAAGAAGGGATCAAGTCACCGCCTCGAAAACGGGCGCGCACAATATCATCTTCGCGTCATCCAGACG
CCGTTCCTGTATCAGGATCCGCAGCAGCAGAAGATGATGAGGCAGAGAAGCCGGGGAGTCAGGATCGGCCACTGGGAGAG
TTGAGTAAGGTCTCCCCAGACGAATTTTGGGAGCGTATGTCTTTCAGGCAGGAATGCGTGTCGGGAGCTGTGACAGGGTT
TTTCACAATGGGGATTAGTTTCAAAGCTGCGGATGAGGATGGTTCTCGGTCGACCGTCTCGCCTCTTGCTCCTCAAGCTG
GACAGGTATCCTCGAATGTCAACAAAAGAGTCATGACATCGCTTATGACCGGCGTTGAGTTCTCCACGAAAGAACGGGCG
ATTAACGCCACAGAATCGATCGAGAACGCTATCAAAGGACTTTGCGAAGGAATCGCACTGGTTCCCGTTCCAGCTATCCA
ACCAACTCGTCCAAAATCAACGAGCAATCAAGAANNNNNNNNNNNNNNNNNNNNNNNNNNNNNNNNNNNNNNNNNNNNNN
TAGCACCACCACGGACGCCACCGCGTCGCAACAGAGAGTTGCTACCCGATATCTCTCCCAATCCCTTTCCAGAACCGNAG
CCGACGTTGGAGACGTACAATTCTCATATCTACGGATCGGTCCTGGCCGTCCGAAAGAAGAAGAAAAGAGCCGAT

Mp4071
ATGTCGAACCTGCGCGACGCATTGCTGAACGGCCTCAAAAATCTGCCCGGCACACGCGAGTTCCATCTCCACGTCCTCGT
CTCATCGCCCAGGAAGCATGGCGGACTGTACCCTTTCTCCTTNNNNNNNNNNNNNNNNNNNCTCCAGGACGTTCTGATTT
TGCTGTCAGAGCAAAGCACCCCAGATTCGCCCCGTATTTTTGTCGCGGCCATTGAGGCGTGCGTGTACAATGTCGCAGCA
ACATCGAGCGCGATATTGTATATCTCAAAGGTCGACTCGACAGGCCAAGCTTCCTATCCTTCCCCCACTGCCACGTTGGT
CAAGTCTTTTCTGTTCTACTACGCCGATCCTGCTACAAGACCTATCGATGTCGACCACCTCTGGATTCAGCTTTTTGCCA
GAGCCCAAAAACAATACGTCTTTCCAAATTCGTCAGAGTATGAGGGGAAGAAATGGTTGAACGATATGAAGCTTTGTAGT
TGGTGGAAAAGGATTTACACAGATGTGTCTACAGAGTTGGCGAGTCGACTGCCTTCGACTGCGCTTGTGAAGCTTTACTA
CCTCATTCCCGGATATNACACAACGANAGCTGAACAATCCTTGAAGATTGCCTCCTCATCCACCGGAAATGACAATCAGA
ATGCACCAATGTGGATATACGGACATCCGTATTCCCAGACCGACATCCCCCTGCCTTGCCCTCAGGACACCGGTTCGTCC
AGTTCCATTGTTAGGAACTTGGGCCACTATATACCTTCTTTTGATGACGATCCCAAGTCGCGTTTCATGGACGAGATTGC
ATATACGACGGAGAAAGAAGGGATCAAGTCACCGCCTCGAAAACGGGCGCGCACAATATCATCTTCGCGTCATCCAGACG
CCGTTCCTGTATCAGGATCCGCAGCAGCAGAAGATGATGAGGCAGAGAAGCCGGGGAGTCAGGATCGGCCACTGGGAGAG
TTGAGTAAGGTCTCCCCAGACGAATTTTGGGAGCGTATGTCTTTCAGGCAGGAATGCGTGTCGGGAGCTGTGACAGGGTT
TTTCACAATGGGGATTAGTTTCAAAGCTGCGGATGAGGATGGTTCTCGGTCGACCGTCTCGCCTCTTGCTCCTCAAGCTG
GACAGGTATCCTCGAATGTCAACAAAAGAGTCATGACATCGCTTATGACCGGCGTTGAGTTCTCCACGAAAGAACGGGCG
ATTAACGCCACAGAATNNNNNNNNNNNNNNNNNNNNGGACTTTGCGAAGGAATCGCACTGGTTCCCGTTCCAGCTATCCA
ACCAACTCGTCCAAAATCAACGAGCAATCAAGAATCNNNNNAACGACAATCGTCCGACCCAGAGGTANNNTCGACATATT
TAGCACCACCACGGACGCCACCGCGTCGCAACAGAGAGTTGCTACCCGATATCTCTCCCAATCCCTTTCCAGAACCGGAG
CCGACGTTGGAGACGTACAATTCTCATATCTACGNNNNNGTCCTGGCCGTCCGAAAGAAGAAGAAAAGAGCCGAT

Mp4124
ATGTCGAACCTGCGCGACGCATTGCTGAACGGCCTCAAAAATCTGCCCGGCACACGCGAGTTCCATCTCCACGTCCTCGT
CTCATCGCCCAGGAAGCATGGCGGACTGTACCCTTTCTCCTTNNNNACCTCGATNCTCTATCTCCAGGACGTTCTGATTT
TGCTGTCAGAGCAAAGCACCCCAGATTCGCCCCGTATTTTTGTCGCGGCCATTGAGGCGTGCGTGTACAATGTCGCAGCA
ACATCGAGCGCGATATTGTATATCTCAAAGGTCGACTCGACAGGCCAAGCTTCCTATCCTTCCCCCACTGCCACGTTGGT
CAAGTCTTTTCTGTTCTACTACGCCGATCCTGCTACAAGACCTATCGATGTCGACCACCTCTGGATTCAGCTTTTTGCCA
GAGCCCAAAAACAATACGTCTTTCCAAATTCGTCAGAGTATGAGGGGAAGAAATGGTTGAACGATATGAAGCTTTGTAGT
TGGTGGAAAAGGATTTACACAGATGTGTCTACAGAGTTGGCGAGTCGACTGCCTTCGACTGCGCTTGTGAAGCTTTACTA
CCTCATTCCCGGATATNACACAACGANAGCTGAACAATCCTTGAAGATTGCCTCCTCATCCACCGGAAATGACAATCAGA
ATGCACCAATGTGGATATACGGACATCCGTATTCCCAGACCGACATCCCCCTGCCTTGCCCTCAGGACACCGGTTCGTCC
AGTTCCATTGTTAGGAACTTGGGCCACTATATACCTTCTTTTGATGACGATCCCAAGTCGCGTTTCATGGACGAGATTGC
ATATACGACGGAGAAAGAAGGGATCAAGTCACCGCCTCGAAAACGGGCGCGCACAATATCATCTTCGCGTCATCCAGACG
CCGTTCCTGTATCAGGATCCGCAGCAGCAGAAGATGATGAGGCAGAGAAGCCGGGGAGTCAGGATCGGCCACTGGGAGAG
TTGAGTAAGGTCTCCCCAGACGAATTTTGGGAGCGTATGTCTTTCAGGCAGGAATGCGTGTCGGGAGCTGTGACAGGGTT
TTTCACAATGGGGATTAGTTTCAAAGCTGCGGATGAGGATGGTTCTCGGTCGACCGTCTCGCCTCTTGCTCCTCAAGCTG
GACAGGTATCCTCGAATGTCAACAAAAGAGTCATGACATCGCTTATGACCGGCGTTGAGTTCTCCACGAAAGAACGGGCG
ATTAACGCCACAGAATCGATCGAGAACGCTATCAAAGGACTTTGCGAAGGAATCGCACTGGTTCCCGTTCCAGCTATCCA
ACCAACTCGTCCAAAATCAACGAGCAATCAAGAATCNNNNNAACGACAATCGTCCGACCCAGAGGTANNNTCGACATATT
TAGCACCACCACGGACGCCACCGCGTCGCAACAGAGAGTTGCTACCCGATATCTCTCCCAATCCCTTTCCAGAACCGGAG
CCGACGTTGGAGACGTACAATTCTCATATCTACGGATCGGTCCTGGCCGTCCGAAAGAAGAAGAAAAGAGCCGAT

Mp4145
ATGTCGAACCTGCGCGACGCATTGCTGAACGGCCTCAAAAATCTGCCCGGCACACGCGAGTTCCATCTCCACGTCCTCGT
CTCATCGCCCAGGAAGCATGGCGGACTGTACCCTTTCTCCTTNNNNACCTCGATGCTCTATCTCCAGGACGTTCTGATTT
TGCTGTCAGAGCAAAGCACCCCAGATTCGCCCCGTATTTTTGTCGCGGCCATTGAGGCGTGCGTGTACAATGTCGCAGCA
ACATCGAGCGCGATATTGTATATCTCAAAGGTCGACTCGACAGGCCAAGCTTCCTATCCTTCCCCCACTGCCACGTTGGT
CAAGTCTTTTCTGTTCTACTACGCCGATCCTGCTACAAGACCTATCGATGTCGACCACCTCTGGATTCAGCTTTTTGCCA
GAGCCCAAAAACAATACGTCTTTCCAAATTCGTCAGAGTATGAGGGGAAGAAATGGTTGAACGATATGAAGCTTTGTAGT
TGGTGGAAAAGGATTTACACAGATGTGTCTACAGAGTTGGCGAGTCGACTGCCTTCGACTGCGCTTGTGAAGCTTTACTA
CCTCATTCCCGGATATAACACAACGANAGCTGAACAATCCTTGAAGATTGCCTCCTCATCCACCGGAAATGACAATCAGA
ATGCACCAATGTGGATATACGGACATCCGTATTCCCAGACCGACATCCCCCTGCCTTGCCCTCAGGACACTGGTTCGTCC
AGTTCCATTGTTAGGAACTTGGGCCACTATATACCTTCTTTTGATGACGATCCCAAGTCGCGTTTCATGGACGAGATTGC
ATATACGACGGAGAAAGAAGGGATCAAGTCACCGCCTCGAAAACGGGCGCGCACAATATCATCTTCGCGTCATCCAGACG
CCGTTCCTGTATCAGGATCCGCAGCAGCAGAAGATGATGAGGCAGAGAAGCCGGGGAGTCAGGATCGGCCACTGGGAGAG
TTGAGTAAGGTCTCCCCAGACGAATTTTGGGAGCGTATGTCTTTCAGGCAGGAATGCGTGTCGGGAGCTGTGACAGGGTT
TTTCACAATGGGGATTAGTTTCAAAGCTGCGGATGAGGATGGTTCTCGGTCGACCGTCTCGCCTCTTGCTCCTCAAGCTG
GACAGGTATCCTCGAATGTCAACAAAAGAGTCATGACATCGCTTATGACCGGCGTTGAGTTCTCCACGAAAGAACGGGCG
ATTAACGCCACAGAATCGATCGAGAACGCTATCAAAGGACTTTGCGAAGGAATCGCACTGGTTCCCGTTCCAGCTATCCA
ACCAACTCGTCCAAAATCAACGAGCAATCAAGAATCNNNNNAACGACAATCGTCCGACCCAGAGGTANNNTCGACATATT
TAGCACCACCACGGACGCCACCGCGTCGCAACAGAGAGTTGCTACCCGATATCTCTCCCAATCCCTTTCCAGAACCGGAG
CCGACGTTGGAGACGTACAATTCTCATATCTACGGATCGGTCCTGGCCGTCCGAAAGAAGAAGAAAAGAGCCGAT

MrPeru
ATGTCGAACCTGCGCGACGCATTGCTGAACGGCCTCAAAAATCTGCCCGGCACACGCGAGTTCCATCTCCACGTCCTCGT
CTCATCGCCCAGGAAGCATGGCGGACTGTACCCTTTCTCCTTNNNNACCTCGATNCTCTATCTCCAGGACGTTCTGATTT
TGCTGTCAGAGCAAAGCACCCCAGATTCGCCCCGTATTTTTGTCGCGGCCATTGAGGCGTGCGTGTACAATGTCGCAGCA
ACATCGAGCGCGATATTGTATATCTCAAAGGTCGACTCGACAGGCCAAGCTTCCTATCCTTCCCCCACTGCCACGTTGGT
CAAGTCTTTTCTGTTCTACTACGCCGATCCTGCTACAAGACCTATCGATGTCGACCACCTCTGGATTCAGCTTTTTGCCA
GAGCCCAAAAACAATACGTCTTTCCAAATTCGTCAGAGTATGAGGGGAAGAAATGGTTGAACGATATGAAGCTTTGTAGT
TGGTGGAAAAGGATTTACACAGATGTGTCTACAGAGTTGGCGAGTCGACTGCCTTCGACTGCGCTTGTGAAGCTTTACTA
CCTCATTCCCGGATATNACACAACGANAGCTGAACAATCCTTGAAGATTGCCTCCTCATCCACCGGAAATGACAATCAGA
ATGCACCAATGTGGATATACGGACATCCGTATTCCCAGACCGACATCCCCCTGCCTTGCCCTCAGGACACTGGTTCGTCC
AGTTCCATTGTTAGGAACTTGGGCCACTATATACCTTCTTTTGATGACGATCCCAAGTCGCGTTTCATGGACGAGATTGC
ATATACGACGGAGAAAGAAGGGATCAAGTCACCGCCTCGAAAACGGGCGCGCACAATATCATCTTCGCGTCATCCAGACG
CCGTTCCTGTATCAGGATCCGCAGCAGCAGAAGATGATGAGGCAGAGAAGCCGGGGAGTCAGGATCGGCCACTGGGAGAG
TTGAGTAAGGTCTCCCCAGACGAATTTTGGGAGCGTATGTCTTTCAGGCAGGAATGCGTGTCGGGAGCTGTGACAGGGTT
TTTCACAATGGGGATTAGTTTCAAAGCTGCGGATGAGGATGGTTCTCGGTCGACCGTCTCGCCTCTTGCTCCTCAAGCTG
GACAGGTATCCTCGAATGTCAACAAAAGAGTCATGACATCGCTTATGACCGGCGTTGAGTTCTCCACGAAAGAACGGGCG
ATTAACGCCACAGAATCGATCGAGAACGCTATCAAAGGACTTTGCGAAGGAATCGCACTGGTTCCCGTTCCAGCTATCCA
ACCAACTCGTCCAAAATCAACGAGCAATCAAGAATCNNNNNAACGACAATCGTCCGACCCAGAGGTANNNTCGACATATT
TAGCACCACCACGGACGCCACCGCGTCGCAACAGAGAGTTGCTACCCGATATCTCTCCCAATCCCTTTCCAGAACCGGAG
CCGACGTTGGAGACGTACAATTCTCATATCTACGGATCGGTCCTGGCCGTCCGAAAGAAGAAGAAAAGAGCCGAT
